kraj,obec_cislo,obec_nazev,hlasy_Pavel,hlasy_Babis,platne_hlasy,platne_hlasy_procenta,ucast_procenta,zapsani_volici
CZ072,506737,Chvalčov,484,451,935,99.36,71.50,1316
CZ072,542318,Blazice,54,47,101,97.12,66.24,157
CZ072,542342,Honětice,15,33,48,100.00,70.59,68
CZ072,542393,Vrbka,78,55,133,100.00,79.64,167
CZ072,549690,Bořenovice,57,68,125,100.00,76.22,164
CZ072,549720,Přílepy,309,302,611,99.51,78.72,780
CZ072,553905,Mrlínek,64,111,175,98.87,79.02,224
CZ072,557188,Šelešovice,79,112,191,99.48,69.57,276
CZ072,587257,Zástřizly,56,38,94,96.91,77.78,126
CZ072,587354,Karolín,78,76,154,99.35,77.11,201
CZ072,587397,Prasklice,66,65,131,100.00,66.84,196
CZ072,588296,Kroměříž,8410,7121,15531,99.42,68.40,22853
CZ072,588300,Bařice-Velké Těšany,151,123,274,100.00,74.05,370
CZ072,588326,Bezměrov,125,186,311,99.36,70.98,441
CZ072,588377,Brusné,105,124,229,100.00,76.08,301
CZ072,588385,Břest,324,219,543,99.63,71.90,758
CZ072,588393,Bystřice pod Hostýnem,2282,2153,4435,99.35,67.91,6573
CZ072,588407,Cetechovice,44,66,110,100.00,74.32,148
CZ072,588431,Dřínov,75,167,242,99.59,71.05,342
CZ072,588458,Holešov,3367,3058,6425,99.41,70.07,9225
CZ072,588474,Horní Lapač,86,68,154,100.00,72.99,211
CZ072,588482,Hoštice,30,49,79,98.75,65.57,122
CZ072,588491,Hulín,1673,1819,3492,99.57,66.77,5254
CZ072,588504,Chomýž,87,108,195,99.49,67.82,289
CZ072,588512,Chropyně,1008,1457,2465,99.88,64.16,3848
CZ072,588521,Kostelany,150,215,365,99.73,72.76,503
CZ072,588547,Chvalnov-Lísky,55,65,120,99.17,61.73,196
CZ072,588555,Jankovice,127,114,241,99.59,76.34,317
CZ072,588563,Jarohněvice,93,74,167,99.40,68.02,247
CZ072,588598,Komárno,105,73,178,100.00,75.42,236
CZ072,588601,Koryčany,656,786,1442,99.59,66.82,2167
CZ072,588610,Kostelec u Holešova,269,306,575,99.14,73.05,794
CZ072,588628,Kunkovice,22,20,42,100.00,75.00,56
CZ072,588636,Kurovice,63,103,166,100.00,76.85,216
CZ072,588644,Kvasice,642,606,1248,99.52,69.55,1803
CZ072,588652,Kyselovice,123,148,271,99.63,70.10,388
CZ072,588661,Lechotice,150,120,270,100.00,78.95,342
CZ072,588695,Litenčice,102,141,243,99.59,66.30,368
CZ072,588709,Loukov,275,224,499,99.60,67.25,745
CZ072,588717,Lubná,140,107,247,98.41,70.31,357
CZ072,588725,Ludslavice,142,139,281,99.65,71.03,397
CZ072,588733,Lutopecny,182,169,351,99.43,72.93,484
CZ072,588741,Martinice,255,256,511,99.80,78.53,652
CZ072,588750,Míškovice,240,153,393,100.00,74.86,525
CZ072,588768,Morkovice-Slížany,693,813,1506,99.67,66.62,2268
CZ072,588784,Němčice,91,126,217,99.54,73.90,295
CZ072,588806,Nítkovice,47,68,115,100.00,59.90,192
CZ072,588814,Nová Dědina,109,152,261,99.24,76.45,344
CZ072,588822,Osíčko,118,138,256,99.61,71.79,358
CZ072,588831,Pacetluky,56,82,138,98.57,76.09,184
CZ072,588849,Pačlavice,162,348,510,99.42,71.25,720
CZ072,588865,Počenice-Tetětice,172,240,412,99.28,71.80,578
CZ072,588873,Podhradní Lhota,151,97,248,98.41,69.23,364
CZ072,588890,Pravčice,194,227,421,99.53,71.33,593
CZ072,588903,Prusinovice,342,350,692,99.28,72.45,962
CZ072,588920,Rajnochovice,179,133,312,99.68,74.00,423
CZ072,588938,Rataje,340,318,658,99.70,72.32,914
CZ072,588946,Roštění,171,218,389,99.23,69.80,563
CZ072,588954,Roštín,207,184,391,99.74,68.65,571
CZ072,588962,Rusava,139,165,304,98.38,66.59,464
CZ072,588971,Rymice,208,173,381,100.00,78.56,485
CZ072,588989,Skaštice,116,115,231,99.57,77.08,301
CZ072,588997,Slavkov pod Hostýnem,195,166,361,99.45,72.89,498
CZ072,589004,Soběsuky,95,133,228,99.13,73.72,312
CZ072,589039,Střílky,164,182,346,98.86,69.44,504
CZ072,589047,Střížovice,73,48,121,100.00,65.05,186
CZ072,589055,Sulimov,42,49,91,100.00,72.22,126
CZ072,589080,Troubky-Zdislavice,81,154,235,100.00,67.53,348
CZ072,589098,Třebětice,96,56,152,100.00,70.05,217
CZ072,589110,Uhřice,33,74,107,100.00,72.30,148
CZ072,589128,Věžky,98,121,219,98.65,65.29,340
CZ072,589136,Vítonice,112,103,215,99.08,66.36,327
CZ072,589152,Zahnašovice,75,95,170,99.42,69.23,247
CZ072,589161,Záříčí,146,278,424,100.00,75.71,560
CZ072,589187,Zborovice,329,418,747,99.47,63.86,1176
CZ072,589195,Zdounky,475,652,1127,99.91,67.83,1663
CZ072,589217,Zlobice,149,177,326,99.39,70.09,468
CZ072,589225,Žalkovice,144,196,340,98.84,74.78,460
CZ072,589233,Žeranovice,309,185,494,99.80,76.86,644
CZ072,550736,Hostětín,88,41,129,99.23,81.25,160
CZ072,550744,Kunovice,1803,1195,2998,99.70,70.57,4265
CZ072,550752,Staré Město,2330,1425,3755,99.60,72.34,5213
CZ072,592005,Uherské Hradiště,8580,5219,13799,99.30,70.24,19785
CZ072,592013,Babice,563,469,1032,99.71,73.14,1415
CZ072,592021,Bánov,640,569,1209,99.51,71.77,1693
CZ072,592030,Bílovice,695,401,1096,99.01,75.46,1467
CZ072,592048,Bojkovice,1070,1306,2376,99.71,69.61,3426
CZ072,592056,Boršice u Blatnice,220,231,451,99.12,71.09,640
CZ072,592064,Boršice,757,511,1268,99.37,75.06,1700
CZ072,592072,Břestek,264,232,496,99.20,73.75,678
CZ072,592081,Březolupy,555,405,960,99.59,71.67,1345
CZ072,592099,Březová,209,304,513,99.42,64.42,801
CZ072,592102,Buchlovice,837,666,1503,99.67,72.19,2089
CZ072,592111,Bystřice pod Lopeníkem,240,239,479,98.97,72.93,665
CZ072,592137,Částkov,97,126,223,99.55,74.42,301
CZ072,592145,Dolní Němčí,735,901,1636,99.51,70.86,2320
CZ072,592153,Drslavice,198,105,303,98.70,75.99,404
CZ072,592170,Hluk,1330,1117,2447,99.27,72.25,3416
CZ072,592188,Horní Němčí,197,294,491,99.39,73.84,669
CZ072,592196,Hostějov,20,11,31,100.00,86.11,36
CZ072,592200,Hradčovice,344,256,600,99.01,77.69,780
CZ072,592218,Huštěnovice,300,272,572,99.31,74.61,772
CZ072,592226,Jalubí,502,511,1013,99.22,73.67,1386
CZ072,592234,Jankovice,118,158,276,100.00,73.40,376
CZ072,592269,Kněžpole,415,240,655,99.70,77.39,849
CZ072,592277,Komňa,147,201,348,99.71,77.95,449
CZ072,592285,Korytná,246,294,540,99.08,73.35,743
CZ072,592293,Kostelany nad Moravou,288,232,520,99.62,72.20,723
CZ072,592307,Košíky,128,114,242,100.00,71.18,340
CZ072,592323,Kudlovice,321,243,564,99.30,73.01,778
CZ072,592340,Lopeník,58,66,124,100.00,68.13,182
CZ072,592366,Medlovice,104,153,257,99.61,70.11,368
CZ072,592382,Mistřice,352,312,664,99.70,72.31,921
CZ072,592391,Modrá,274,159,433,100.00,79.01,548
CZ072,592404,Nedachlebice,240,204,444,99.33,71.07,629
CZ072,592412,Nedakonice,524,410,934,99.89,73.18,1279
CZ072,592421,Nezdenice,194,231,425,100.00,70.02,607
CZ072,592439,Nivnice,1150,792,1942,99.59,73.42,2656
CZ072,592447,Ořechov,304,164,468,99.36,78.80,599
CZ072,592455,Ostrožská Lhota,473,413,886,99.55,75.36,1181
CZ072,592463,Ostrožská Nová Ves,1135,837,1972,99.25,72.50,2742
CZ072,592471,Osvětimany,204,279,483,99.38,70.33,691
CZ072,592480,Pašovice,219,183,402,99.26,71.81,564
CZ072,592498,Pitín,276,250,526,99.43,72.07,734
CZ072,592501,Podolí,285,220,505,99.80,73.02,693
CZ072,592510,Polešovice,699,481,1180,99.49,76.86,1543
CZ072,592528,Popovice,337,280,617,99.20,75.39,825
CZ072,592536,Prakšice,371,239,610,99.03,75.89,813
CZ072,592552,Rudice,102,147,249,98.81,72.41,348
CZ072,592561,Salaš,141,120,261,99.62,75.50,347
CZ072,592579,Slavkov,142,206,348,99.15,68.55,512
CZ072,592587,Staré Hutě,61,29,90,100.00,85.71,105
CZ072,592609,Starý Hrozenkov,266,283,549,99.82,75.65,727
CZ072,592617,Strání,927,933,1860,99.79,67.41,2765
CZ072,592625,Stříbrnice,142,109,251,99.60,73.47,343
CZ072,592633,Stupava,58,46,104,100.00,72.22,144
CZ072,592641,Suchá Loz,321,312,633,99.84,74.07,856
CZ072,592650,Sušice,226,190,416,100.00,77.76,535
CZ072,592668,Svárov,85,58,143,99.31,77.84,185
CZ072,592676,Šumice,538,395,933,99.57,72.36,1295
CZ072,592692,Topolná,530,373,903,98.15,72.50,1269
CZ072,592706,Traplice,357,304,661,99.40,70.82,939
CZ072,592714,Tučapy,82,76,158,98.75,76.56,209
CZ072,592722,Tupesy,373,267,640,99.84,71.78,893
CZ072,592731,Uherský Brod,5365,3762,9127,99.42,70.08,13099
CZ072,592749,Uherský Ostroh,1242,1022,2264,99.34,67.38,3384
CZ072,592757,Újezdec,58,84,142,100.00,73.58,193
CZ072,592773,Vápenice,38,72,110,100.00,71.43,154
CZ072,592781,Vážany,151,84,235,99.58,69.30,342
CZ072,592790,Velehrad,430,237,667,99.11,75.11,896
CZ072,592803,Veletiny,204,119,323,99.69,74.83,433
CZ072,592820,Vlčnov,1091,645,1736,99.60,74.11,2352
CZ072,592838,Vyškovec,20,56,76,98.70,61.60,125
CZ072,592846,Záhorovice,274,293,567,99.82,70.95,802
CZ072,592854,Zlámanec,105,89,194,100.00,75.49,257
CZ072,592862,Zlechov,500,442,942,99.47,73.52,1288
CZ072,592871,Žítková,34,60,94,98.95,65.97,144
CZ072,500062,Krhová,729,511,1240,99.36,75.45,1654
CZ072,500071,Poličná,585,420,1005,99.41,70.31,1438
CZ072,541630,Vsetín,7698,5828,13526,99.30,67.65,20136
CZ072,541648,Branky,284,258,542,99.27,68.68,795
CZ072,541711,Bystřička,337,230,567,99.82,69.61,816
CZ072,541800,Dolní Bečva,608,493,1101,99.10,73.28,1516
CZ072,542644,Francova Lhota,514,361,875,99.54,73.43,1197
CZ072,542679,Halenkov,621,610,1231,99.35,66.08,1875
CZ072,542687,Horní Bečva,864,609,1473,99.46,68.82,2152
CZ072,542725,Horní Lideč,472,329,801,99.38,77.22,1045
CZ072,542750,Hošťálková,708,502,1210,99.10,69.02,1769
CZ072,542768,Hovězí,792,598,1390,99.50,74.69,1873
CZ072,542784,Huslenky,660,562,1222,99.51,69.34,1771
CZ072,542814,Hutisko-Solanec,640,475,1115,99.82,70.11,1596
CZ072,542831,Choryně,229,217,446,100.00,73.23,609
CZ072,542865,Jablůnka,671,451,1122,99.20,71.04,1592
CZ072,542903,Jarcová,274,208,482,99.79,72.78,665
CZ072,542911,Karolinka,660,673,1333,99.40,66.78,2008
CZ072,542946,Kateřinice,356,230,586,99.66,71.01,828
CZ072,542989,Kelč,803,686,1489,99.80,71.70,2081
CZ072,542997,Kladeruby,142,127,269,100.00,76.20,353
CZ072,543021,Kunovice,198,195,393,99.49,77.60,509
CZ072,543098,Lačnov,300,189,489,99.59,73.83,665
CZ072,544264,Leskovec,221,163,384,99.48,71.35,541
CZ072,544302,Lešná,680,540,1220,99.59,74.57,1644
CZ072,544370,Lidečko,721,362,1083,99.72,74.18,1464
CZ072,544396,Liptál,450,397,847,99.41,71.66,1189
CZ072,544418,Loučka,228,203,431,98.85,69.87,624
CZ072,544434,Lužná,186,148,334,99.11,67.67,498
CZ072,544469,Malá Bystřice,123,73,196,100.00,73.13,268
CZ072,544507,Mikulůvka,259,204,463,100.00,76.78,603
CZ072,544566,Nový Hrozenkov,870,553,1423,99.79,68.23,2090
CZ072,544574,Oznice,173,140,313,99.37,81.19,388
CZ072,544621,Police,147,159,306,98.71,70.45,440
CZ072,544655,Pozděchov,218,113,331,100.00,71.03,466
CZ072,544671,Prlov,126,177,303,98.70,75.80,405
CZ072,544698,Prostřední Bečva,613,492,1105,99.73,71.67,1546
CZ072,544728,Pržno,212,155,367,98.66,70.32,529
CZ072,544787,Ratiboř,596,406,1002,99.50,70.92,1420
CZ072,544841,Rožnov pod Radhoštěm,5554,3377,8931,99.41,68.86,13056
CZ072,544850,Růžďka,308,207,515,98.28,72.38,724
CZ072,544906,Seninka,112,86,198,100.00,78.26,253
CZ072,544914,Střelná,183,160,343,99.42,72.63,475
CZ072,544922,Střítež nad Bečvou,306,181,487,99.80,70.72,690
CZ072,544949,Valašská Bystřice,724,516,1240,99.60,69.98,1779
CZ072,544990,Valašská Polanka,528,305,833,99.40,73.38,1142
CZ072,545058,Valašské Meziříčí,6748,5180,11928,99.49,69.27,17317
CZ072,545147,Velká Lhota,201,108,309,99.68,75.06,413
CZ072,545163,Velké Karlovice,1098,550,1648,99.82,74.67,2211
CZ072,545198,Vidče,609,366,975,99.59,68.75,1424
CZ072,545210,Vigantice,422,181,603,99.67,73.04,831
CZ072,545236,Zašová,1043,653,1696,99.12,74.29,2303
CZ072,545244,Zděchov,172,163,335,100.00,71.89,466
CZ072,545252,Zubří,1758,1306,3064,99.61,69.95,4400
CZ072,553026,Valašská Senice,138,108,246,99.60,72.65,340
CZ072,556866,Lhota u Vsetína,240,200,440,99.77,71.13,620
CZ072,569496,Podolí,55,83,138,99.28,66.19,210
CZ072,570346,Janová,259,179,438,98.87,73.15,607
CZ072,570371,Ústí,203,155,358,99.44,72.93,495
CZ072,500011,Želechovice nad Dřevnicí,692,429,1121,99.47,74.54,1512
CZ072,534811,Podhradí,69,46,115,99.14,70.30,165
CZ072,535184,Tichov,109,96,205,99.51,83.06,248
CZ072,538744,Březnice,528,306,834,99.88,79.00,1057
CZ072,544931,Študlov,178,120,298,99.33,73.35,409
CZ072,545112,Valašské Příkazy,113,53,166,99.40,70.17,238
CZ072,549401,Pozlovice,479,273,752,99.08,77.29,982
CZ072,549436,Komárov,108,72,180,98.90,68.16,267
CZ072,549444,Oldřichovice,122,118,240,99.59,76.51,315
CZ072,549461,Pohořelice,320,208,528,100.00,75.54,699
CZ072,549533,Poteč,297,147,444,99.55,73.00,611
CZ072,549550,Lhotsko,99,60,159,99.38,73.06,219
CZ072,549622,Lípa,357,175,532,99.63,76.07,702
CZ072,549649,Tečovice,478,283,761,99.74,73.60,1038
CZ072,556874,Petrůvka,110,72,182,99.45,70.11,261
CZ072,556980,Rokytnice,175,159,334,100.00,70.17,476
CZ072,557102,Bohuslavice nad Vláří,108,124,232,98.72,78.33,300
CZ072,557145,Lukoveček,180,123,303,100.00,83.93,361
CZ072,557170,Ostrata,121,90,211,99.53,66.67,318
CZ072,573434,Lhota,352,196,548,99.82,78.21,702
CZ072,585068,Zlín,25892,15583,41475,99.49,71.13,58624
CZ072,585076,Biskupice,216,192,408,99.51,71.93,570
CZ072,585092,Bohuslavice u Zlína,236,211,447,99.55,76.40,589
CZ072,585106,Bratřejov,319,163,482,100.00,76.75,628
CZ072,585114,Brumov-Bylnice,1530,1356,2886,99.24,66.99,4341
CZ072,585131,Březová,159,142,301,100.00,77.58,388
CZ072,585149,Březůvky,217,191,408,99.76,71.63,571
CZ072,585157,Dešná,53,54,107,100.00,68.15,157
CZ072,585165,Dobrkovice,74,82,156,100.00,75.36,207
CZ072,585173,Dolní Lhota,240,148,388,99.23,76.22,513
CZ072,585181,Doubravy,210,147,357,99.17,77.09,467
CZ072,585190,Drnovice,140,90,230,98.29,72.45,323
CZ072,585203,Držková,122,89,211,100.00,71.04,297
CZ072,585211,Fryšták,1450,840,2290,99.31,75.62,3052
CZ072,585220,Halenkovice,526,584,1110,99.28,73.43,1524
CZ072,585238,Haluzice,9,38,47,97.92,75.00,64
CZ072,585246,Horní Lhota,237,114,351,100.00,76.97,456
CZ072,585254,Hostišová,161,114,275,99.64,66.19,417
CZ072,585262,Hrobice,145,116,261,99.62,68.23,384
CZ072,585271,Hřivínův Újezd,152,175,327,100.00,77.12,424
CZ072,585289,Hvozdná,498,282,780,99.36,76.66,1024
CZ072,585301,Jasenná,330,246,576,99.48,74.90,773
CZ072,585319,Jestřabí,84,68,152,100.00,67.86,224
CZ072,585327,Kaňovice,79,83,162,99.39,73.54,223
CZ072,585343,Kašava,353,211,564,98.77,79.42,719
CZ072,585432,Loučka,149,115,264,99.62,66.92,396
CZ072,585441,Ludkovice,265,148,413,99.28,74.95,555
CZ072,585459,Luhačovice,1897,1311,3208,99.72,73.20,4396
CZ072,585467,Lukov,631,350,981,99.49,70.94,1390
CZ072,585483,Lutonina,113,147,260,99.24,80.62,325
CZ072,585491,Machová,206,176,382,99.74,73.51,521
CZ072,585505,Mysločovice,290,132,422,100.00,81.15,520
CZ072,585513,Napajedla,2099,1902,4001,99.63,70.02,5747
CZ072,585521,Návojná,208,190,398,100.00,72.10,552
CZ072,585530,Nedašov,360,330,690,98.43,67.66,1036
CZ072,585548,Nedašova Lhota,181,203,384,99.74,70.13,549
CZ072,585556,Neubuz,168,116,284,98.95,75.93,378
CZ072,585599,Otrokovice,4730,4428,9158,99.30,66.96,13780
CZ072,585611,Podkopná Lhota,91,112,203,99.51,75.00,272
CZ072,585661,Provodov,330,162,492,99.80,80.42,613
CZ072,585670,Racková,337,162,499,99.40,76.41,657
CZ072,585726,Sazovice,321,170,491,100.00,78.06,629
CZ072,585734,Sehradice,231,172,403,99.26,71.23,570
CZ072,585751,Slavičín,1975,1734,3709,99.60,73.66,5060
CZ072,585769,Slopné,234,123,357,99.44,82.53,435
CZ072,585777,Slušovice,959,657,1616,99.20,72.30,2253
CZ072,585793,Spytihněv,498,483,981,98.89,73.59,1348
CZ072,585807,Šanov,119,127,246,99.60,64.66,382
CZ072,585815,Šarovy,85,72,157,98.74,75.71,210
CZ072,585831,Štítná nad Vláří-Popov,692,563,1255,99.68,73.63,1710
CZ072,585858,Tlumačov,664,625,1289,99.61,67.08,1929
CZ072,585866,Trnava,322,291,613,99.67,67.21,915
CZ072,585874,Ublo,101,82,183,99.46,78.30,235
CZ072,585882,Újezd,379,283,662,99.85,69.97,949
CZ072,585891,Valašské Klobouky,1588,1085,2673,99.44,70.26,3826
CZ072,585912,Velký Ořechov,247,218,465,100.00,78.41,593
CZ072,585921,Veselá,244,240,484,98.98,74.43,657
CZ072,585939,Vizovice,1928,861,2789,99.32,72.74,3863
CZ072,585955,Vlachovice,484,374,858,99.31,72.67,1189
CZ072,585963,Vlčková,117,114,231,100.00,70.00,330
CZ072,585971,Všemina,338,305,643,99.84,72.44,889
CZ072,585980,Vysoké Pole,249,214,463,100.00,73.93,629
CZ072,585998,Zádveřice-Raková,516,331,847,99.65,73.02,1164
CZ072,586013,Žlutava,364,334,698,99.71,74.79,936
CZ072,586871,Lipová,89,119,208,100.00,73.76,282
CZ072,586919,Rudimov,106,49,155,99.36,78.39,199
CZ072,586960,Křekov,70,23,93,100.00,69.40,134
CZ072,586994,Vlachova Lhota,60,49,109,97.32,67.07,167
CZ072,587052,Karlovice,72,85,157,99.37,80.20,197
CZ072,588318,Bělov,137,76,213,100.00,78.60,271
CZ072,592251,Kelníky,68,37,105,100.00,77.21,136
CZ080,569526,Milotice nad Opavou,64,123,187,100.00,60.91,307
CZ080,569551,Nové Heřminovy,57,114,171,99.42,59.72,288
CZ080,569577,Oborná,82,179,261,100.00,73.11,357
CZ080,569607,Býkov-Láryšov,33,51,84,98.82,69.67,122
CZ080,597180,Bruntál,2873,4521,7394,99.64,59.74,12422
CZ080,597198,Bílčice,27,100,127,100.00,63.82,199
CZ080,597201,Bohušov,61,119,180,100.00,56.78,317
CZ080,597210,Brantice,307,435,742,99.60,67.36,1106
CZ080,597228,Břidličná,533,994,1527,99.67,60.69,2526
CZ080,597252,Dětřichov nad Bystřicí,72,148,220,98.65,63.90,349
CZ080,597287,Dolní Moravice,162,118,280,99.64,72.05,390
CZ080,597317,Dvorce,214,394,608,99.67,59.75,1021
CZ080,597325,Heřmanovice,69,130,199,99.00,75.85,265
CZ080,597341,Holčovice,100,283,383,99.74,62.75,612
CZ080,597350,Horní Benešov,394,774,1168,99.57,65.38,1794
CZ080,597368,Horní Město,145,286,431,98.85,65.37,667
CZ010,500054,Praha 1,12637,2392,15029,99.43,68.87,21949
CZ010,500089,Praha 2,18063,3829,21892,99.54,69.92,31472
CZ010,500097,Praha 3,27133,7207,34340,99.52,69.60,49592
CZ010,500119,Praha 4,51902,15962,67864,99.51,73.28,93120
CZ010,500143,Praha 5,34136,8857,42993,99.49,72.53,59616
CZ010,500178,Praha 6,45526,10807,56333,99.40,76.53,74093
CZ010,500186,Praha 7,18321,3827,22148,99.51,72.44,30737
CZ010,500208,Praha 8,39951,14259,54210,99.49,71.64,76103
CZ010,500216,Praha 9,21497,6814,28311,99.51,72.00,39563
CZ010,500224,Praha 10,43782,13160,56942,99.51,71.51,80082
CZ010,538060,Praha-Běchovice,863,308,1171,99.57,76.83,1532
CZ010,538078,Praha-Benice,303,102,405,99.02,82.29,497
CZ010,538124,Praha-Březiněves,658,200,858,99.42,76.24,1132
CZ010,538175,Praha-Dolní Počernice,1189,342,1531,99.29,79.53,1939
CZ010,538205,Praha-Dubeč,1557,576,2133,99.63,77.91,2748
CZ010,538213,Praha 20,5832,2410,8242,99.57,75.05,11035
CZ010,538302,Praha-Klánovice,1590,411,2001,99.50,77.70,2588
CZ010,538353,Praha-Koloděje,703,202,905,99.23,82.09,1111
CZ010,538361,Praha-Kolovraty,1763,426,2189,99.27,82.25,2682
CZ010,538388,Praha-Královice,146,77,223,100.00,75.34,296
CZ010,538400,Praha-Křeslice,516,155,671,99.55,85.88,786
CZ010,538531,Praha-Nedvězí,122,55,177,99.44,77.73,229
CZ010,538736,Praha-Satalice,1297,320,1617,99.39,84.87,1917
CZ010,538931,Praha 22,4894,1350,6244,99.52,77.65,8088
CZ010,538949,Praha 21,4439,1461,5900,99.49,78.87,7524
CZ010,539007,Praha-Vinoř,1813,597,2410,99.34,79.31,3060
CZ010,539449,Praha-Lipence,1257,347,1604,99.44,75.33,2144
CZ010,539465,Praha-Lochkov,328,105,433,99.31,75.04,581
CZ010,539589,Praha-Přední Kopanina,277,82,359,99.72,84.15,429
CZ010,539601,Praha 16,3599,1025,4624,99.42,76.92,6049
CZ010,539635,Praha-Řeporyje,2107,498,2605,99.50,77.05,3399
CZ010,539678,Praha-Slivenec,1666,424,2090,99.05,77.86,2715
CZ010,539694,Praha 13,22324,7474,29798,99.50,72.88,41112
CZ010,539724,Praha-Šeberov,1304,445,1749,99.15,78.16,2257
CZ010,539791,Praha-Újezd,1419,408,1827,99.62,80.52,2279
CZ010,539864,Praha-Zbraslav,4348,1193,5541,99.50,74.95,7430
CZ010,539899,Praha-Zličín,2762,762,3524,99.58,76.51,4628
CZ010,547034,Praha 11,26801,12226,39027,99.44,73.12,53718
CZ010,547042,Praha-Kunratice,3639,1013,4652,99.68,78.12,5979
CZ010,547051,Praha-Libuš,3308,1167,4475,99.58,72.90,6166
CZ010,547107,Praha 12,21345,8617,29962,99.52,74.45,40459
CZ010,547115,Praha-Velká Chuchle,1143,249,1392,99.50,76.91,1819
CZ010,547140,Praha-Lysolaje,615,128,743,99.60,80.13,931
CZ010,547158,Praha-Nebušice,959,288,1247,99.52,72.13,1740
CZ010,547174,Praha 17,8383,3721,12104,99.48,71.38,17054
CZ010,547271,Praha-Suchdol,2825,719,3544,99.58,79.50,4477
CZ010,547298,Praha-Ďáblice,1607,477,2084,99.29,78.48,2677
CZ010,547301,Praha-Dolní Chabry,2210,490,2700,99.74,80.52,3362
CZ010,547310,Praha-Čakovice,4311,1455,5766,99.72,76.53,7562
CZ010,547328,Praha-Troja,632,132,764,99.61,81.25,944
CZ010,547344,Praha 19,2828,975,3803,99.50,78.02,4900
CZ010,547361,Praha 14,15713,6239,21952,99.58,70.09,31473
CZ010,547379,Praha-Dolní Měcholupy,1358,346,1704,99.24,79.56,2158
CZ010,547387,Praha 15,12637,4657,17294,99.47,73.65,23650
CZ010,547395,Praha-Petrovice,2292,819,3111,99.39,73.18,4277
CZ010,547409,Praha-Štěrboholy,841,243,1084,98.64,80.12,1373
CZ010,547417,Praha 18,6967,2671,9638,99.51,73.72,13145
CZ010,554782,Praha,502438,155501,657939,99.49,73.17,904378
CZ080,546950,Nová Pláň,40,13,53,92.98,91.94,62
CZ080,551694,Velká Štáhle,68,124,192,100.00,70.07,274
CZ080,551708,Dlouhá Stráň,22,43,65,100.00,83.33,78
CZ080,551724,Mezina,87,105,192,99.48,61.86,312
CZ080,551732,Moravskoslezský Kočov,124,228,352,99.44,73.44,482
CZ080,551767,Staré Město,201,312,513,99.42,70.68,730
CZ080,551783,Valšov,44,87,131,97.76,67.00,200
CZ080,551805,Horní Životice,56,147,203,100.00,76.89,264
CZ080,551813,Staré Heřminovy,31,90,121,99.18,73.49,166
CZ080,551821,Tvrdkov,53,78,131,100.00,65.17,201
CZ080,551848,Petrovice,40,50,90,98.90,71.65,127
CZ080,551864,Dívčí Hrad,34,98,132,100.00,57.89,228
CZ080,551872,Hlinka,20,63,83,100.00,51.88,160
CZ080,551881,Slezské Pavlovice,11,69,80,98.77,55.10,147
CZ080,551902,Malá Štáhle,31,43,74,100.00,75.51,98
CZ080,551911,Stará Ves,140,161,301,100.00,70.99,424
CZ080,551929,Andělská Hora,101,132,233,100.00,69.14,337
CZ080,551945,Rudná pod Pradědem,75,126,201,100.00,64.01,314
CZ080,551996,Ludvíkov,141,82,223,99.55,74.42,301
CZ080,552003,Čaková,94,101,195,99.49,70.50,278
CZ080,597392,Hošťálkovy,143,218,361,100.00,70.10,515
CZ080,597431,Janov,43,126,169,100.00,66.27,255
CZ080,597449,Jindřichov,192,416,608,99.84,62.53,974
CZ080,597457,Jiříkov,80,82,162,99.39,62.93,259
CZ080,597473,Karlova Studánka,298,117,415,99.76,88.89,468
CZ080,597481,Karlovice,217,317,534,99.81,62.99,862
CZ080,597511,Krasov,80,119,199,98.51,68.94,293
CZ080,597520,Krnov,5034,6635,11669,99.45,63.66,18441
CZ080,597538,Křišťanovice,30,100,130,100.00,61.90,210
CZ080,597546,Leskovec nad Moravicí,84,169,253,99.61,67.20,378
CZ080,597554,Lichnov,191,346,537,100.00,64.86,831
CZ080,597571,Liptaň,89,169,258,99.61,63.95,405
CZ080,597589,Lomnice,92,155,247,99.60,63.04,395
CZ080,597601,Malá Morávka,684,282,966,99.59,84.27,1151
CZ080,597635,Město Albrechtice,715,1190,1905,99.27,68.09,2820
CZ080,597716,Osoblaha,154,262,416,99.05,52.17,805
CZ080,597724,Razová,104,163,267,98.89,61.64,438
CZ080,597741,Roudno,40,93,133,100.00,72.68,183
CZ080,597775,Rusín,35,40,75,100.00,60.98,123
CZ080,597783,Rýmařov,1688,2471,4159,99.66,64.16,6507
CZ080,597791,Ryžoviště,65,253,318,99.69,65.77,485
CZ080,597813,Slezské Rudoltice,63,192,255,100.00,61.59,414
CZ080,597872,Světlá Hora,281,457,738,99.86,63.71,1160
CZ080,597881,Svobodné Heřmanice,101,214,315,99.68,71.82,440
CZ080,597899,Široká Niva,113,223,336,99.70,71.10,474
CZ080,597911,Třemešná,138,376,514,99.23,69.16,749
CZ080,597937,Úvalno,185,365,550,99.64,70.14,787
CZ080,597945,Václavov u Bruntálu,74,125,199,99.50,53.19,376
CZ080,597961,Vrbno pod Pradědem,953,1642,2595,99.50,63.38,4115
CZ080,597970,Vysoká,46,128,174,100.00,67.44,258
CZ080,597988,Zátor,259,363,622,100.00,65.13,955
CZ080,507091,Nýdek,530,548,1078,99.81,65.82,1644
CZ080,507181,Pržno,354,228,582,100.00,67.52,862
CZ080,507237,Komorní Lhotka,438,418,856,99.53,72.33,1189
CZ080,507423,Janovice,574,512,1086,99.82,68.82,1581
CZ080,507458,Košařiska,89,107,196,100.00,67.35,291
CZ080,507547,Milíkov,391,361,752,100.00,70.70,1065
CZ080,511633,Bocanovice,157,118,275,99.64,73.99,373
CZ080,511935,Bukovec,359,358,717,99.31,70.17,1029
CZ080,511951,Dolní Lomná,274,245,519,99.24,68.91,759
CZ080,511986,Horní Lomná,83,118,201,99.01,64.24,316
CZ080,512028,Písek,496,488,984,99.39,66.09,1498
CZ080,512176,Hrádek,558,474,1032,99.52,70.78,1465
CZ080,512184,Metylovice,533,503,1036,99.52,74.68,1394
CZ080,512192,Horní Domaslavice,319,241,560,99.82,74.90,749
CZ080,549665,Raškovice,547,610,1157,99.06,74.39,1570
CZ080,549673,Krásná,230,177,407,98.31,69.35,597
CZ080,552488,Vojkovice,215,231,446,99.33,76.36,588
CZ080,552500,Pazderna,91,94,185,100.00,71.98,257
CZ080,552518,Nošovice,259,351,610,99.03,73.51,838
CZ080,552526,Nižní Lhoty,89,78,167,99.40,76.02,221
CZ080,552542,Dobratice,471,336,807,99.63,77.66,1043
CZ080,552551,Staré Město,489,390,879,99.55,74.89,1179
CZ080,552569,Staříč,557,678,1235,99.28,71.99,1728
CZ080,552577,Pstruží,337,267,604,99.34,77.06,789
CZ080,552593,Malenovice,321,171,492,99.39,83.78,592
CZ080,552607,Dolní Tošanovice,87,124,211,100.00,73.26,288
CZ080,552615,Vělopolí,100,68,168,100.00,75.34,223
CZ080,552623,Třanovice,325,304,629,99.06,76.23,833
CZ080,552631,Horní Tošanovice,180,194,374,99.47,70.94,530
CZ080,552640,Řeka,159,161,320,98.77,71.21,455
CZ080,552658,Smilovice,298,178,476,99.79,72.49,658
CZ080,552674,Střítež,294,301,595,99.83,73.13,815
CZ080,552682,Vyšní Lhoty,229,296,525,99.43,73.03,723
CZ080,552691,Žabeň,276,260,536,99.26,75.31,717
CZ080,554014,Návsí,1047,979,2026,99.85,68.08,2982
CZ080,554928,Vendryně,1332,1205,2537,99.22,73.12,3497
CZ080,556971,Ropice,488,446,934,99.36,72.42,1298
CZ080,557226,Písečná,337,270,607,99.51,77.15,792
CZ080,568163,Žermanice,87,109,196,100.00,72.32,271
CZ080,568791,Soběšovice,310,253,563,99.65,72.34,781
CZ080,568813,Pražmo,249,277,526,99.62,71.16,742
CZ080,568830,Řepiště,652,519,1171,99.74,78.06,1504
CZ080,569631,Sviadnov,718,571,1289,99.61,76.42,1696
CZ080,598003,Frýdek-Místek,13365,14693,28058,99.51,65.27,43225
CZ080,598011,Baška,1295,1038,2333,99.36,74.69,3145
CZ080,598020,Bílá,180,98,278,98.93,77.84,361
CZ080,598038,Brušperk,1350,1094,2444,99.71,76.02,3224
CZ080,598046,Bruzovice,286,261,547,99.09,73.11,755
CZ080,598062,Bystřice,1587,1275,2862,99.41,68.79,4185
CZ080,598071,Čeladná,1066,806,1872,99.57,73.38,2562
CZ080,598089,Dobrá,993,912,1905,99.74,74.13,2578
CZ080,598101,Dolní Domaslavice,410,390,800,98.77,72.78,1113
CZ080,598135,Fryčovice,728,720,1448,99.38,76.40,1907
CZ080,598143,Frýdlant nad Ostravicí,3131,2661,5792,99.40,72.98,7986
CZ080,598160,Hnojník,418,439,857,99.19,71.94,1201
CZ080,598232,Hrčava,35,92,127,100.00,61.65,206
CZ080,598259,Jablunkov,1590,1267,2857,99.62,65.59,4376
CZ080,598275,Kaňovice,113,107,220,100.00,78.85,279
CZ080,598321,Kozlovice,1026,793,1819,99.73,76.72,2380
CZ080,598348,Krmelín,874,584,1458,99.32,78.80,1863
CZ080,598356,Kunčice pod Ondřejníkem,763,583,1346,99.78,70.79,1907
CZ080,598364,Lhotka,158,180,338,99.41,75.39,451
CZ080,598399,Lučina,485,400,885,99.44,74.60,1193
CZ080,598445,Morávka,341,367,708,99.02,73.79,969
CZ080,598453,Mosty u Jablunkova,1096,936,2032,99.75,66.26,3079
CZ080,598542,Ostravice,846,687,1533,99.22,72.45,2134
CZ080,598551,Palkovice,1165,934,2099,99.53,78.16,2702
CZ080,598569,Paskov,1105,1083,2188,99.73,69.21,3170
CZ080,598674,Sedliště,619,415,1034,99.33,78.63,1324
CZ080,598691,Hukvaldy,729,579,1308,99.47,76.36,1722
CZ080,598747,Staré Hamry,170,190,360,99.45,72.55,499
CZ080,598810,Třinec,8329,8732,17061,99.60,62.12,27586
CZ080,552739,Horní Suchá,863,1404,2267,99.21,64.19,3560
CZ080,555088,Havířov,14095,20991,35086,99.57,61.62,57200
CZ080,555291,Chotěbuz,407,363,770,99.35,74.88,1035
CZ080,568864,Doubrava,163,459,622,100.00,64.39,966
CZ080,598178,Horní Bludovice,826,705,1531,99.87,76.27,2010
CZ080,598917,Karviná,7397,16978,24375,99.73,59.00,41444
CZ080,598925,Albrechtice,884,1293,2177,99.32,71.09,3085
CZ080,598933,Český Těšín,5699,6101,11800,99.51,63.62,18639
CZ080,598941,Dětmarovice,1004,1513,2517,99.06,71.85,3556
CZ080,598968,Dolní Lutyně,1223,1830,3053,99.74,71.89,4262
CZ080,599051,Bohumín,4145,6301,10446,99.63,62.50,16786
CZ080,599069,Orlová,4420,9456,13876,99.70,59.94,23230
CZ080,599077,Petrovice u Karviné,1159,1588,2747,99.57,70.71,3903
CZ080,599085,Petřvald,1483,2418,3901,99.52,67.43,5816
CZ080,599107,Rychvald,1735,2426,4161,99.55,69.33,6035
CZ080,599140,Stonava,330,638,968,99.38,69.13,1409
CZ080,599158,Těrlicko,1335,1497,2832,99.19,74.69,3824
CZ080,500046,Libhošť,475,519,994,99.30,73.17,1379
CZ080,500259,Veřovice,616,490,1106,99.55,71.31,1558
CZ080,546984,Bílov,110,205,315,100.00,72.75,433
CZ080,547000,Životice u Nového Jičína,169,198,367,99.46,72.07,512
CZ080,554065,Jakubčovice nad Odrou,171,175,346,98.86,70.99,493
CZ080,554171,Šenov u Nového Jičína,608,483,1091,99.73,66.50,1645
CZ080,554910,Vražné,199,246,445,99.78,64.54,691
CZ080,554936,Bítov,160,144,304,99.35,79.33,387
CZ080,555312,Kujavy,126,155,281,100.00,64.60,435
CZ080,556858,Bravantice,238,327,565,99.82,75.46,766
CZ080,568406,Slatina,209,221,430,99.77,74.44,579
CZ080,568422,Velké Albrechtice,278,408,686,100.00,74.32,923
CZ080,568431,Bordovice,214,162,376,99.47,74.56,507
CZ080,568473,Závišice,377,268,645,99.69,77.58,834
CZ080,568481,Bernartice nad Odrou,377,220,597,99.17,79.11,761
CZ080,568511,Hostašovice,239,212,451,98.90,73.08,624
CZ080,568546,Kunín,482,467,949,99.37,67.23,1422
CZ080,568554,Rybí,462,290,752,99.08,77.93,974
CZ080,568562,Heřmanice u Oder,96,121,217,100.00,76.68,283
CZ080,568571,Heřmánky,49,51,100,100.00,72.99,137
CZ080,568589,Mankovice,141,166,307,99.35,67.91,455
CZ080,568643,Kateřinice,211,191,402,99.26,74.72,542
CZ080,568686,Mošnov,175,228,403,99.51,67.50,600
CZ080,568716,Skotnice,226,261,487,99.80,73.60,663
CZ080,568732,Ženklava,321,288,609,99.35,68.49,895
CZ080,568741,Albrechtičky,259,141,400,99.26,71.20,566
CZ080,568775,Pustějov,293,309,602,99.50,76.87,787
CZ080,569666,Hladké Životice,238,366,604,99.83,73.72,822
CZ080,569747,Vrchy,48,92,140,100.00,74.47,188
CZ080,569755,Trnávka,221,244,465,99.79,78.85,591
CZ080,599191,Nový Jičín,6135,5522,11657,99.72,64.66,18094
CZ080,599212,Bartošovice,379,513,892,99.55,66.92,1339
CZ080,599247,Bílovec,2002,2127,4129,99.45,70.68,5874
CZ080,599344,Frenštát pod Radhoštěm,3173,2637,5810,99.40,68.90,8486
CZ080,599352,Fulnek,1405,1582,2987,99.37,68.63,4386
CZ080,599409,Hodslavice,572,380,952,99.58,71.29,1341
CZ080,599468,Jeseník nad Odrou,485,567,1052,99.25,69.28,1530
CZ080,599506,Jistebník,529,466,995,99.50,75.47,1325
CZ080,599565,Kopřivnice,5842,5331,11173,99.60,65.93,17020
CZ080,599603,Lichnov,483,464,947,99.68,77.49,1226
CZ080,599646,Luboměř,122,90,212,99.07,69.71,307
CZ080,599689,Mořkov,743,664,1407,99.15,73.56,1929
CZ080,599701,Odry,1726,1980,3706,99.60,65.82,5656
CZ080,599743,Petřvald,582,481,1063,99.53,77.84,1372
CZ080,599808,Příbor,2540,2140,4680,99.38,71.00,6637
CZ080,599832,Sedlnice,507,455,962,99.79,71.46,1349
CZ080,599867,Spálov,273,214,487,99.19,69.06,711
CZ080,599905,Starý Jičín,1036,744,1780,99.83,78.87,2267
CZ080,599921,Studénka,2344,2598,4942,99.54,66.58,7459
CZ080,599930,Suchdol nad Odrou,729,705,1434,99.10,69.33,2087
CZ080,599948,Štramberk,1103,881,1984,99.40,71.82,2779
CZ080,599956,Tichá,609,509,1118,99.47,77.09,1458
CZ080,599964,Tísek,320,271,591,99.66,78.03,760
CZ080,599999,Trojanovice,903,689,1592,99.69,76.40,2093
CZ080,555321,Opava (nečleněná část města),14118,12048,26166,99.53,67.24,39109
CZ080,555339,Malé Hoštice,558,520,1078,99.81,77.70,1390
CZ080,555355,Komárov,403,321,724,99.45,68.68,1060
CZ080,555371,Suché Lazce,343,309,652,98.49,78.07,848
CZ080,555401,Podvihov,236,242,478,99.79,78.14,613
CZ080,555410,Zlatníky,127,114,241,100.00,83.68,288
CZ080,555436,Milostovice,99,100,199,99.00,85.90,234
CZ080,555461,Vlaštovičky,98,141,239,98.76,74.01,327
CZ080,556700,Vávrovice,441,315,756,99.08,73.39,1041
CZ080,505927,Opava,16423,14110,30533,99.50,68.34,44910
CZ080,506192,Bohuslavice,571,464,1035,99.62,75.97,1369
CZ080,506214,Bolatice,1282,1283,2565,99.65,72.88,3532
CZ080,506320,Brumovice,375,520,895,99.44,74.44,1209
CZ080,506451,Březová,329,526,855,99.19,79.37,1086
CZ080,506460,Budišov nad Budišovkou,521,803,1324,99.25,59.42,2250
CZ080,506702,Dolní Benešov,1033,1259,2292,99.61,71.28,3231
CZ080,506753,Háj ve Slezsku,1084,951,2035,99.66,77.58,2632
CZ080,507016,Hlučín,3591,3993,7584,99.58,69.03,11037
CZ080,507105,Hněvošice,340,281,621,99.68,77.39,805
CZ080,507113,Holasovice,337,445,782,99.11,72.39,1090
CZ080,507261,Hrabyně,400,409,809,99.26,76.62,1065
CZ080,507270,Hradec nad Moravicí,1603,1634,3237,99.45,75.81,4295
CZ080,507334,Chuchelná,331,429,760,99.74,73.13,1042
CZ080,507377,Jakartovice,209,355,564,99.82,64.72,873
CZ080,507504,Kobeřice,922,960,1882,99.26,74.01,2570
CZ080,507580,Kravaře,1872,1880,3752,99.71,70.87,5310
CZ080,507920,Litultovice,257,304,561,99.64,76.29,738
CZ080,507971,Ludgeřovice,1414,1545,2959,99.60,75.43,3939
CZ080,508128,Markvartovice,596,671,1267,99.84,76.02,1672
CZ080,508144,Melč,111,240,351,99.72,66.92,526
CZ080,508373,Mokré Lazce,394,348,742,99.87,81.85,909
CZ080,509574,Oldřišov,389,427,816,99.27,74.48,1105
CZ080,509612,Otice,450,430,880,99.55,75.23,1175
CZ080,509647,Píšť,530,703,1233,99.60,71.52,1731
CZ080,509736,Pustá Polom,457,364,821,99.52,75.41,1094
CZ080,509841,Raduň,398,289,687,99.85,76.44,900
CZ080,510131,Skřipov,266,327,593,99.83,77.55,766
CZ080,510289,Slavkov,662,578,1240,99.52,77.01,1618
CZ080,510297,Služovice,192,291,483,99.79,74.46,650
CZ080,510343,Stěbořice,455,461,916,99.67,80.40,1143
CZ080,510378,Sudice,165,201,366,100.00,70.79,517
CZ080,510432,Šilheřovice,379,522,901,99.78,71.01,1273
CZ080,510483,Štěpánkovice,808,990,1798,99.39,72.01,2512
CZ080,510491,Štítina,464,277,741,99.46,76.73,971
CZ080,510891,Velké Heraltice,353,545,898,99.78,69.61,1293
CZ080,510939,Velké Hoštice,546,497,1043,99.33,73.84,1422
CZ080,511021,Vítkov,1088,1858,2946,99.83,64.60,4571
CZ080,511161,Vršovice,188,136,324,99.69,77.38,420
CZ080,512745,Těškovice,267,228,495,99.20,74.78,670
CZ080,512869,Strahovice,253,291,544,99.63,76.04,718
CZ080,512893,Nové Lublice,34,71,105,100.00,69.08,152
CZ080,512907,Kyjovice,290,243,533,99.63,78.10,685
CZ080,512923,Chlebičov,363,323,686,99.13,75.88,912
CZ080,512974,Bělá,128,259,387,99.74,72.98,533
CZ080,547131,Svatoňovice,45,89,134,100.00,61.19,219
CZ080,547182,Kozmice,556,554,1110,99.73,74.20,1500
CZ080,547191,Jezdkovice,60,97,157,100.00,80.93,194
CZ080,553042,Mladecko,30,55,85,98.84,74.78,115
CZ080,553051,Dolní Životice,387,226,613,99.19,72.20,856
CZ080,553093,Hlavnice,176,206,382,98.71,74.14,522
CZ080,553107,Bratříkovice,32,62,94,97.92,78.05,123
CZ080,553115,Lhotka u Litultovic,41,75,116,99.15,66.48,176
CZ080,553158,Neplachovice,257,309,566,99.65,76.34,744
CZ080,553492,Závada,131,223,354,100.00,75.64,468
CZ080,554197,Branka u Opavy,323,354,677,99.85,78.20,867
CZ080,555274,Nové Sedlice,173,138,311,99.68,77.04,405
CZ080,568180,Kružberk,41,77,118,98.33,60.30,199
CZ080,568198,Staré Těchanovice,35,60,95,100.00,79.17,120
CZ080,568210,Hať,742,698,1440,99.52,70.88,2043
CZ080,568228,Darkovice,416,393,809,99.63,77.48,1048
CZ080,568236,Děhylov,229,230,459,99.78,76.92,598
CZ080,568244,Vřesina,474,502,976,99.69,77.26,1271
CZ080,568261,Budišovice,294,178,472,99.79,78.44,603
CZ080,568279,Mikolajice,94,79,173,99.43,77.33,225
CZ080,568317,Radkov,86,155,241,100.00,61.48,392
CZ080,568333,Štáblovice,150,219,369,99.73,68.65,539
CZ080,568341,Uhlířov,149,98,247,100.00,79.17,312
CZ080,568368,Hlubočec,176,168,344,99.71,76.67,450
CZ080,568376,Rohov,154,187,341,100.00,72.40,471
CZ080,569097,Moravice,53,73,126,99.21,65.13,195
CZ080,569101,Třebom,31,86,117,100.00,62.90,186
CZ080,569895,Dobroslavice,286,210,496,100.00,78.11,635
CZ080,569909,Chvalíkovice,176,242,418,99.29,77.53,543
CZ080,569950,Čermná ve Slezsku,33,121,154,99.35,55.36,280
CZ080,570036,Větřkovice,231,200,431,99.31,72.94,595
CZ080,597821,Sosnová,52,165,217,99.09,67.18,326
CZ080,500291,Vřesina,1040,712,1752,99.32,77.30,2282
CZ080,506711,Dolní Lhota,538,424,962,99.79,80.02,1206
CZ080,510882,Velká Polom,686,532,1218,99.51,77.32,1583
CZ080,554049,Olbramice,257,176,433,100.00,75.96,570
CZ080,545911,Moravská Ostrava a Přívoz,8767,8499,17266,99.52,59.54,29155
CZ080,546046,Slezská Ostrava,4420,5673,10093,99.58,62.59,16197
CZ080,546135,Ostrava-Jih,21277,26544,47821,99.59,61.10,78649
CZ080,546224,Poruba,15631,15930,31561,99.56,63.76,49749
CZ080,554219,Nová Bělá,810,575,1385,99.50,79.41,1753
CZ080,554227,Vítkovice,1011,1863,2874,99.62,49.97,5780
CZ080,554235,Stará Bělá,1461,994,2455,99.19,77.78,3182
CZ080,554243,Pustkovec,498,307,805,99.75,74.31,1086
CZ080,554286,Mariánské Hory a Hulváky,2383,3044,5427,99.38,59.97,9108
CZ080,554308,Petřkovice,964,865,1829,99.62,71.37,2578
CZ080,554324,Lhotka,485,362,847,99.88,78.08,1086
CZ080,554332,Hošťálkovice,549,550,1099,99.73,77.88,1415
CZ080,554367,Nová Ves,161,176,337,100.00,60.83,554
CZ080,554375,Proskovice,444,306,750,99.60,76.52,984
CZ080,554430,Michálkovice,757,940,1697,99.47,63.63,2681
CZ080,554537,Radvanice a Bartovice,1434,2072,3506,99.63,68.52,5137
CZ080,554561,Krásné Pole,938,726,1664,99.64,76.29,2189
CZ080,554570,Martinov,331,365,696,99.57,73.12,956
CZ080,554588,Polanka nad Odrou,1736,1264,3000,99.50,75.11,4014
CZ080,554669,Hrabová,1187,1087,2274,99.26,72.52,3162
CZ080,554685,Svinov,1326,1175,2501,99.40,72.50,3476
CZ080,554715,Třebovice,656,481,1137,99.74,76.15,1497
CZ080,554723,Plesná,539,442,981,99.19,80.28,1232
CZ080,554821,Ostrava,67765,74240,142005,99.55,63.26,225620
CZ080,568449,Zbyslavice,224,173,397,100.00,78.77,504
CZ080,569119,Čavisov,170,155,325,98.78,80.84,407
CZ080,569500,Horní Lhota,253,273,526,99.43,76.22,694
CZ080,598739,Stará Ves nad Ondřejnicí,985,788,1773,99.66,77.42,2298
CZ080,598798,Šenov,1940,1946,3886,99.51,75.49,5181
CZ080,598836,Václavovice,659,598,1257,99.52,77.43,1635
CZ080,598879,Vratimov,2113,2009,4122,99.47,71.31,5814
CZ080,599549,Klimkovice,1611,1233,2844,99.51,76.79,3723
CZ071,523917,Bělá pod Pradědem,658,524,1182,99.16,71.46,1668
CZ071,524891,Bernartice,124,269,393,99.75,61.56,640
CZ071,525227,Bílá Voda,68,71,139,99.29,51.09,274
CZ071,533491,Černá Voda,142,152,294,100.00,64.76,454
CZ071,536148,Javorník,503,817,1320,99.70,64.37,2057
CZ071,536385,Jeseník,2867,2692,5559,99.55,62.66,8917
CZ071,540030,Lipová-lázně,692,627,1319,99.10,72.61,1833
CZ071,540382,Mikulovice,443,826,1269,99.45,65.04,1962
CZ071,540684,Písečná,243,280,523,99.62,63.71,824
CZ071,541036,Stará Červená Voda,91,253,344,99.42,69.48,498
CZ071,541117,Supíkovice,115,209,324,99.08,62.05,527
CZ071,541214,Uhelná,103,135,238,99.58,58.58,408
CZ071,541249,Vápenná,214,395,609,99.67,61.78,989
CZ071,541303,Vidnava,194,383,577,100.00,60.74,950
CZ071,541346,Vlčice,90,137,227,100.00,66.76,340
CZ071,541575,Žulová,228,387,615,99.51,65.05,950
CZ071,553301,Hradec-Nová Ves,72,114,186,100.00,63.92,291
CZ071,553468,Velká Kraš,108,239,347,99.71,60.52,575
CZ071,553484,Skorošice,125,223,348,98.86,61.65,571
CZ071,557218,Kobylá nad Vidnavkou,60,139,199,100.00,62.38,319
CZ071,569330,Ostružná,455,104,559,99.82,92.56,605
CZ071,569356,Česká Ves,563,708,1271,98.91,66.93,1920
CZ071,569453,Velké Kunětice,60,223,283,100.00,67.87,417
CZ071,597996,Zlaté Hory,702,1138,1840,98.87,60.26,3090
CZ071,500135,Kozlov,51,97,148,99.33,68.66,217
CZ071,500160,Město Libavá,125,218,343,100.00,64.23,534
CZ071,500496,Olomouc,34585,20411,54996,99.53,69.73,79300
CZ071,500526,Bělkovice-Lašťany,727,537,1264,99.68,71.69,1770
CZ071,500623,Bílá Lhota,313,358,671,99.70,72.21,932
CZ071,500801,Blatec,191,189,380,100.00,75.40,504
CZ071,500852,Bohuňovice,850,676,1526,99.22,75.33,2043
CZ071,500861,Bouzov,449,436,885,99.22,73.54,1213
CZ071,500879,Bystročice,233,216,449,99.12,69.80,649
CZ071,501476,Dlouhá Loučka,478,577,1055,100.00,68.44,1543
CZ071,501646,Dolany,981,596,1577,99.43,74.54,2129
CZ071,501751,Drahanovice,478,546,1024,99.61,71.99,1428
CZ071,501794,Dub nad Moravou,451,461,912,99.67,72.45,1263
CZ071,501841,Grygov,498,359,857,99.65,72.88,1180
CZ071,502146,Hlubočky,1144,1098,2242,99.51,66.55,3387
CZ071,502235,Hněvotín,621,386,1007,99.41,74.49,1360
CZ071,502405,Hnojice,179,151,330,99.10,70.55,472
CZ071,502545,Horka nad Moravou,817,675,1492,99.40,75.14,1999
CZ071,502839,Cholina,208,194,402,99.01,73.68,551
CZ071,503142,Jívová,178,199,377,100.00,79.37,475
CZ071,503304,Kožušany-Tážaly,263,232,495,99.40,76.97,647
CZ071,503444,Litovel,2643,2526,5169,99.21,68.18,7643
CZ071,503622,Luká,250,275,525,100.00,74.05,709
CZ071,503657,Lutín,858,860,1718,99.83,68.44,2516
CZ071,503738,Majetín,363,316,679,99.27,72.53,943
CZ071,504246,Mladeč,168,178,346,99.14,61.12,571
CZ071,504441,Náklo,421,405,826,98.45,71.28,1177
CZ071,504505,Náměšť na Hané,691,522,1213,99.75,72.21,1684
CZ071,504785,Paseka,370,408,778,99.87,70.31,1108
CZ071,505013,Příkazy,362,362,724,99.04,70.22,1041
CZ071,505081,Senice na Hané,561,480,1041,99.43,72.56,1443
CZ071,505111,Slatinice,468,522,990,99.20,74.33,1344
CZ071,505161,Štěpánov,1038,941,1979,99.80,70.59,2809
CZ071,505188,Šternberk,3788,3287,7075,99.49,66.95,10627
CZ071,505218,Šumvald,428,463,891,99.44,68.19,1314
CZ071,505269,Těšetice,427,342,769,98.97,73.37,1059
CZ071,505293,Troubelice,568,533,1101,99.91,75.05,1471
CZ071,505366,Tršice,548,482,1030,99.04,73.86,1408
CZ071,505501,Újezd,315,436,751,99.87,65.25,1154
CZ071,505587,Uničov,3169,2830,5999,99.68,67.49,8917
CZ071,505609,Velká Bystřice,1258,699,1957,99.59,74.28,2648
CZ071,505650,Velký Týnec,1013,695,1708,99.53,74.20,2314
CZ071,505668,Velký Újezd,410,344,754,99.87,71.29,1059
CZ071,505862,Žerotín,183,85,268,98.89,73.64,368
CZ071,540005,Lipinka,60,50,110,99.10,66.07,168
CZ071,545279,Domašov nad Bystřicí,93,190,283,100.00,68.36,414
CZ071,546976,Hraničné Petrovice,25,53,78,100.00,69.03,113
CZ071,547018,Střeň,168,183,351,98.87,72.60,489
CZ071,547026,Bystrovany,353,209,562,99.12,75.20,754
CZ071,547077,Samotišky,527,256,783,99.75,76.90,1026
CZ071,547093,Mutkov,18,14,32,100.00,78.05,41
CZ071,547123,Komárov,60,73,133,100.00,73.48,181
CZ071,552011,Štarnov,274,201,475,99.16,74.49,643
CZ071,552020,Hlušovice,395,172,567,99.65,74.64,765
CZ071,552038,Loučka,58,48,106,97.25,63.01,173
CZ071,552062,Bílsko,73,47,120,99.17,70.35,172
CZ071,552071,Dubčany,79,70,149,100.00,80.11,186
CZ071,552089,Tovéř,252,130,382,99.22,76.54,503
CZ071,552119,Věrovany,388,407,795,99.62,73.14,1091
CZ071,552151,Skrbeň,354,289,643,99.38,70.56,917
CZ071,552160,Pňovice,243,268,511,98.46,67.58,768
CZ071,552178,Haňovice,153,127,280,99.64,77.41,363
CZ071,552186,Červenka,434,380,814,98.91,70.83,1162
CZ071,552194,Slavětín,54,50,104,100.00,70.95,148
CZ071,552216,Luběnice,154,136,290,97.97,72.73,407
CZ071,552232,Loučany,204,171,375,99.73,73.01,515
CZ071,552259,Olbramice,54,72,126,99.21,69.02,184
CZ071,552267,Senička,108,108,216,99.54,80.44,271
CZ071,552305,Lipina,41,51,92,100.00,64.34,143
CZ071,552313,Domašov u Šternberka,82,104,186,100.00,68.63,271
CZ071,552330,Hlásnice,88,45,133,97.79,75.56,180
CZ071,552348,Mladějovice,188,205,393,99.49,68.70,575
CZ071,552356,Babice,132,164,296,100.00,80.87,366
CZ071,552364,Ústín,141,119,260,99.62,74.57,350
CZ071,552372,Medlov,428,469,897,99.34,71.50,1263
CZ071,552381,Nová Hradečná,211,237,448,99.78,71.73,626
CZ071,552399,Želechovice,87,66,153,98.08,83.42,187
CZ071,552402,Bukovany,282,132,414,99.76,78.45,529
CZ071,552411,Přáslavice,411,392,803,99.14,69.17,1171
CZ071,552429,Svésedlice,79,55,134,100.00,67.00,200
CZ071,552437,Krčmaň,144,145,289,99.66,75.13,386
CZ071,552445,Daskabát,179,159,338,99.71,70.33,482
CZ071,554103,Řídeč,56,63,119,100.00,73.01,163
CZ071,554901,Křelov-Břuchotín,619,401,1020,99.22,73.12,1406
CZ071,554944,Mrsklesy,208,193,401,99.26,73.32,551
CZ071,568392,Doloplazy,436,303,739,99.46,70.90,1048
CZ071,568872,Charváty,255,236,491,99.59,71.94,702
CZ071,568911,Měrotín,81,59,140,100.00,62.22,225
CZ071,568961,Vilémov,131,132,263,99.25,77.94,340
CZ071,569003,Liboš,191,143,334,99.70,66.34,505
CZ071,569054,Strukov,35,49,84,100.00,69.42,121
CZ071,569771,Suchonice,60,49,109,100.00,74.66,146
CZ071,569798,Horní Loděnice,64,103,167,100.00,63.98,261
CZ071,569844,Lužice,134,81,215,100.00,68.25,315
CZ071,597414,Huzová,82,194,276,100.00,61.74,447
CZ071,597678,Moravský Beroun,494,918,1412,99.16,62.14,2295
CZ071,597686,Norberčany,29,107,136,100.00,63.55,214
CZ071,506761,Alojzov,83,74,157,100.00,76.59,205
CZ071,506770,Seloutky,172,139,311,99.68,79.39,393
CZ071,543543,Hruška,21,93,114,99.13,62.84,183
CZ071,544710,Vincencov,47,30,77,100.00,77.00,100
CZ071,549967,Hačky,43,35,78,98.73,83.16,95
CZ071,549983,Polomí,41,44,85,100.00,73.28,116
CZ071,557196,Pavlovice u Kojetína,60,79,139,99.29,61.14,229
CZ071,558419,Držovice,462,376,838,98.94,73.27,1156
CZ071,589250,Prostějov,12404,10688,23092,99.51,67.46,34409
CZ071,589268,Bedihošť,223,355,578,98.97,69.11,845
CZ071,589276,Bílovice-Lutotín,138,173,311,99.68,74.64,418
CZ071,589284,Biskupice,56,101,157,99.37,67.23,235
CZ071,589292,Bohuslavice,117,134,251,99.21,72.49,349
CZ071,589306,Bousín,50,40,90,100.00,79.65,113
CZ071,589314,Brodek u Konice,227,240,467,99.57,70.31,667
CZ071,589322,Brodek u Prostějova,363,434,797,99.87,68.32,1168
CZ071,589331,Březsko,73,49,122,99.19,69.49,177
CZ071,589349,Budětsko,111,140,251,99.60,75.68,333
CZ071,589357,Buková,77,92,169,99.41,68.55,248
CZ071,589365,Čehovice,130,172,302,100.00,73.84,409
CZ071,589381,Čechy pod Kosířem,313,326,639,99.07,76.88,839
CZ071,589390,Čelčice,107,190,297,99.66,70.45,423
CZ071,589403,Čelechovice na Hané,314,405,719,99.45,67.89,1065
CZ071,589420,Dětkovice,172,150,322,99.69,76.72,421
CZ071,589438,Dobrochov,104,92,196,99.49,71.90,274
CZ071,589446,Dobromilice,133,264,397,99.75,63.78,624
CZ071,589454,Doloplazy,94,181,275,99.64,62.73,440
CZ071,589462,Drahany,102,151,253,100.00,63.41,399
CZ071,589489,Dřevnovice,100,163,263,100.00,71.66,367
CZ071,589497,Dzbel,60,97,157,100.00,78.50,200
CZ071,589501,Hluchov,95,105,200,100.00,68.97,290
CZ071,589519,Horní Štěpánov,224,306,530,100.00,74.44,712
CZ071,589527,Hradčany-Kobeřice,88,122,210,100.00,65.83,319
CZ071,589535,Hrdibořice,63,66,129,98.47,76.16,172
CZ071,589543,Hrubčice,232,224,456,100.00,72.04,633
CZ071,589560,Hvozd,188,192,380,99.48,70.87,539
CZ071,589578,Ivaň,113,151,264,99.62,72.80,364
CZ071,589586,Jesenec,83,84,167,99.40,69.42,242
CZ071,589594,Kladky,98,96,194,100.00,68.31,284
CZ071,589608,Klenovice na Hané,185,250,435,98.86,66.17,665
CZ071,589616,Klopotovice,93,81,174,98.86,74.58,236
CZ071,589624,Konice,694,753,1447,99.38,67.16,2168
CZ071,589632,Kostelec na Hané,836,729,1565,99.49,68.82,2287
CZ071,589641,Koválovice-Osíčany,50,115,165,98.80,74.22,225
CZ071,589659,Kralice na Hané,495,413,908,99.13,71.44,1285
CZ071,589667,Krumsín,153,162,315,99.37,69.82,454
CZ071,589675,Laškov,169,167,336,99.70,74.56,452
CZ071,589683,Lešany,89,122,211,100.00,72.01,293
CZ071,589691,Lipová,245,227,472,98.74,79.01,605
CZ071,589705,Ludmírov,135,145,280,98.59,64.11,443
CZ071,589713,Malé Hradisko,124,116,240,99.59,77.74,310
CZ071,589721,Mořice,106,170,276,100.00,67.15,411
CZ071,589730,Mostkovice,488,488,976,99.90,73.37,1333
CZ071,589748,Myslejovice,209,181,390,99.74,73.50,532
CZ071,589756,Němčice nad Hanou,405,577,982,99.70,65.06,1514
CZ071,589764,Nezamyslice,343,382,725,99.04,65.36,1120
CZ071,589772,Niva,72,115,187,98.42,72.24,263
CZ071,589799,Obědkovice,37,104,141,99.30,66.05,215
CZ071,589802,Ohrozim,167,125,292,100.00,80.22,364
CZ071,589811,Ochoz,70,49,119,99.17,79.47,151
CZ071,589829,Olšany u Prostějova,484,527,1011,99.31,72.94,1397
CZ071,589837,Ondratice,83,115,198,99.50,71.33,279
CZ071,589845,Otaslavice,355,394,749,99.60,71.76,1048
CZ071,589853,Otinoves,92,70,162,98.78,73.87,222
CZ071,589870,Pěnčín,169,219,388,99.74,68.61,567
CZ071,589888,Pivín,229,212,441,99.55,76.64,578
CZ071,589896,Plumlov,770,571,1341,99.85,71.52,1882
CZ071,589918,Prostějovičky,95,82,177,99.44,69.80,255
CZ071,589926,Protivanov,318,310,628,98.74,77.94,816
CZ071,589934,Přemyslovice,315,349,664,99.40,68.37,977
CZ071,589942,Ptení,297,291,588,99.16,68.55,865
CZ071,589951,Raková u Konice,69,64,133,99.25,77.46,173
CZ071,589969,Rakůvka,28,38,66,100.00,75.86,87
CZ071,589977,Rozstání,163,183,346,100.00,71.49,484
CZ071,589993,Skalka,90,76,166,100.00,73.13,227
CZ071,590002,Skřípov,86,109,195,99.49,71.79,273
CZ071,590011,Slatinky,192,152,344,100.00,74.14,464
CZ071,590029,Smržice,487,438,925,99.25,74.26,1255
CZ071,590045,Srbce,9,36,45,97.83,71.88,64
CZ071,590053,Stařechovice,148,193,341,98.84,79.68,433
CZ071,590061,Stínava,55,27,82,100.00,67.21,122
CZ071,590070,Stražisko,116,133,249,100.00,69.36,359
CZ071,590088,Suchdol,213,166,379,99.21,81.62,468
CZ071,590096,Šubířov,61,65,126,98.44,57.14,224
CZ071,590100,Tištín,90,141,231,100.00,62.26,371
CZ071,590118,Tvorovice,66,95,161,99.38,68.07,238
CZ071,590126,Určice,393,372,765,99.61,71.51,1074
CZ071,590134,Víceměřice,101,152,253,100.00,67.65,374
CZ071,590142,Vícov,144,152,296,99.66,72.09,412
CZ071,590151,Vitčice,45,51,96,100.00,67.13,143
CZ071,590177,Vranovice-Kelčice,172,182,354,98.06,73.23,493
CZ071,590185,Vrbátky,468,483,951,99.89,73.80,1290
CZ071,590193,Vrchoslavice,158,216,374,99.47,78.83,477
CZ071,590207,Vřesovice,196,133,329,99.40,75.23,440
CZ071,590215,Výšovice,176,139,315,99.06,74.13,429
CZ071,590223,Zdětín,101,111,212,98.60,69.81,308
CZ071,590240,Želeč,122,187,309,98.41,73.54,427
CZ071,500151,Luboměř pod Strážnou,18,51,69,100.00,65.09,106
CZ071,511382,Přerov,10243,11820,22063,99.55,66.12,33525
CZ071,512231,Bělotín,389,527,916,99.57,65.62,1405
CZ071,512281,Beňov,191,226,417,99.52,76.60,547
CZ071,512401,Bezuchov,59,55,114,97.44,76.97,152
CZ071,512532,Bochoř,252,309,561,99.47,71.39,790
CZ071,512800,Brodek u Přerova,534,557,1091,99.36,71.62,1533
CZ071,512826,Buk,101,133,234,99.57,74.37,316
CZ071,512877,Býškovice,115,140,255,99.61,86.49,296
CZ071,512982,Citov,167,145,312,100.00,73.76,423
CZ071,513059,Čelechovice,36,45,81,100.00,77.88,104
CZ071,513067,Černotín,286,225,511,99.22,79.60,647
CZ071,513105,Dobrčice,75,53,128,100.00,67.37,190
CZ071,513199,Dolní Újezd,297,448,745,99.60,75.48,991
CZ071,513211,Domaželice,140,178,318,99.38,72.89,439
CZ071,513229,Dřevohostice,323,464,787,99.62,66.00,1197
CZ071,513491,Horní Moštěnice,475,521,996,99.40,73.84,1357
CZ071,513636,Hrabůvka,102,104,206,100.00,80.47,256
CZ071,513733,Hradčany,110,89,199,99.00,83.75,240
CZ071,513750,Hranice,4943,4569,9512,99.33,68.11,14065
CZ071,513768,Hustopeče nad Bečvou,606,409,1015,99.71,75.41,1350
CZ071,513873,Jindřichov,181,119,300,99.67,77.78,387
CZ071,514047,Klokočí,114,61,175,99.43,80.73,218
CZ071,514055,Kojetín,1192,1752,2944,99.33,64.21,4618
CZ071,514152,Kokory,296,311,607,99.35,72.22,846
CZ071,514446,Lazníčky,52,63,115,100.00,71.43,161
CZ071,514471,Lazníky,117,180,297,99.66,68.82,433
CZ071,514497,Lhota,77,133,210,100.00,77.78,270
CZ071,514527,Lhotka,25,18,43,100.00,87.76,49
CZ071,514705,Lipník nad Bečvou,2027,2220,4247,99.41,66.91,6385
CZ071,514772,Lipová,75,94,169,100.00,74.78,226
CZ071,514802,Líšná,55,81,136,100.00,69.74,195
CZ071,515191,Lobodice,135,231,366,99.46,64.34,572
CZ071,515329,Malhotice,108,121,229,100.00,76.85,298
CZ071,515418,Milenov,116,135,251,99.21,72.91,347
CZ071,515477,Milotice nad Bečvou,106,65,171,100.00,81.04,211
CZ071,515787,Nelešovice,47,49,96,97.96,65.77,149
CZ071,515825,Oldřichov,28,38,66,100.00,71.74,92
CZ071,516201,Opatovice,261,192,453,99.78,69.74,651
CZ071,516350,Oprostovice,17,42,59,100.00,84.29,70
CZ071,516619,Osek nad Bečvou,393,388,781,99.49,76.96,1020
CZ071,516635,Paršovice,127,95,222,99.11,73.44,305
CZ071,516686,Partutovice,184,129,313,99.37,76.64,411
CZ071,516694,Pavlovice u Přerova,201,235,436,99.77,75.61,578
CZ071,516864,Podolí,37,74,111,100.00,70.70,157
CZ071,516899,Polkovice,123,140,263,99.62,68.39,386
CZ071,516911,Polom,40,91,131,100.00,57.46,228
CZ071,517101,Potštát,267,358,625,99.84,63.94,979
CZ071,517151,Prosenice,202,251,453,100.00,71.90,630
CZ071,517208,Provodovice,53,44,97,100.00,78.86,123
CZ071,517224,Přestavlky,70,90,160,99.38,76.30,211
CZ071,517275,Radíkov,52,61,113,99.12,84.44,135
CZ071,517321,Radkova Lhota,40,91,131,100.00,66.50,197
CZ071,517437,Radkovy,22,60,82,98.80,71.19,118
CZ071,517445,Radotín,35,77,112,99.12,80.14,141
CZ071,517534,Radslavice,286,365,651,99.85,70.87,920
CZ071,517569,Radvanice,73,86,159,100.00,70.35,226
CZ071,517585,Rakov,93,143,236,100.00,73.07,323
CZ071,517607,Rokytnice,355,474,829,99.40,71.10,1173
CZ071,517615,Rouské,77,83,160,98.77,77.14,210
CZ071,517666,Říkovice,109,151,260,99.62,66.41,393
CZ071,517747,Skalička,205,142,347,99.43,67.77,515
CZ071,517836,Sobíšky,47,57,104,100.00,79.39,131
CZ071,517844,Soběchleby,139,214,353,98.60,76.99,465
CZ071,517887,Stará Ves,143,193,336,99.12,67.94,499
CZ071,517909,Střítež nad Ludinou,298,244,542,99.63,78.16,696
CZ071,518026,Sušice,77,113,190,99.48,70.74,270
CZ071,519031,Teplice nad Bečvou,154,115,269,99.26,80.42,337
CZ071,519146,Tovačov,583,777,1360,99.34,70.35,1946
CZ071,519651,Troubky,533,644,1177,99.66,72.90,1620
CZ071,520047,Tučín,98,165,263,100.00,76.23,345
CZ071,520306,Ústí,183,128,311,99.68,72.22,432
CZ071,520420,Veselíčko,227,261,488,99.19,69.79,705
CZ071,521531,Všechovice,264,274,538,98.72,75.48,722
CZ071,522775,Zámrsky,71,63,134,99.26,73.37,184
CZ071,523453,Žákovice,60,96,156,100.00,80.41,194
CZ071,523640,Želatovice,137,194,331,99.70,76.32,435
CZ071,547433,Vlkoš,180,240,420,99.06,77.66,546
CZ071,547450,Výkleky,78,68,146,100.00,64.32,227
CZ071,547514,Zábeštní Lhota,50,68,118,100.00,79.19,149
CZ071,552755,Věžky,41,89,130,100.00,72.22,180
CZ071,552771,Čechy,87,108,195,100.00,73.03,267
CZ071,552780,Křtomil,119,131,250,99.21,75.90,332
CZ071,552810,Nahošovice,25,65,90,98.90,70.00,130
CZ071,552836,Turovice,68,83,151,99.34,74.88,203
CZ071,552844,Olšovec,167,135,302,100.00,74.20,407
CZ071,552879,Uhřičice,96,192,288,98.97,65.39,445
CZ071,552887,Stříbrnice,58,71,129,100.00,70.11,184
CZ071,552909,Měrovice nad Hanou,107,207,314,100.00,63.18,497
CZ071,552950,Šišma,55,77,132,100.00,74.16,178
CZ071,552968,Horní Těšice,50,58,108,100.00,87.80,123
CZ071,552984,Dolní Těšice,25,13,38,97.44,75.00,52
CZ071,553000,Oplocany,66,122,188,100.00,63.73,295
CZ071,556998,Jezernice,201,187,388,99.23,72.68,538
CZ071,569135,Císařov,81,106,187,100.00,74.31,253
CZ071,569143,Křenovice,118,139,257,98.85,73.45,354
CZ071,569178,Bohuslávky,82,107,189,98.95,71.80,266
CZ071,569194,Grymov,39,72,111,100.00,83.46,133
CZ071,569259,Dolní Nětčice,75,79,154,99.35,73.46,211
CZ071,569267,Hlinsko,49,95,144,97.96,83.52,176
CZ071,569275,Horní Nětčice,58,80,138,100.00,71.88,192
CZ071,569283,Kladníky,45,42,87,100.00,73.11,119
CZ071,569542,Horní Újezd,151,129,280,99.64,78.71,357
CZ071,570061,Špičky,88,83,171,100.00,76.68,223
CZ071,570079,Týn nad Bečvou,228,225,453,98.91,67.55,678
CZ071,500020,Petrov nad Desnou,319,331,650,99.69,65.27,999
CZ071,523704,Šumperk,7133,6410,13543,99.48,67.40,20207
CZ071,525588,Bludov,1010,792,1802,99.50,73.59,2461
CZ071,525804,Bohdíkov,274,435,709,98.75,68.32,1051
CZ071,525880,Bohuslavice,141,135,276,99.64,71.76,386
CZ071,525979,Bohutín,192,207,399,100.00,68.91,579
CZ071,526169,Branná,197,73,270,99.63,79.24,342
CZ071,530727,Brníčko,172,203,375,99.47,73.49,513
CZ071,532894,Bušín,95,154,249,99.60,76.45,327
CZ071,533688,Dlouhomilov,127,149,276,99.64,70.66,392
CZ071,534927,Dubicko,338,318,656,99.70,75.98,866
CZ071,535532,Hanušovice,575,934,1509,99.54,61.25,2475
CZ071,535770,Horní Studénky,127,80,207,98.10,74.30,284
CZ071,535885,Hoštejn,117,129,246,98.01,73.39,342
CZ071,536091,Hrabišín,207,247,454,100.00,64.49,704
CZ071,536113,Hynčina,26,84,110,100.00,63.22,174
CZ071,536288,Jedlí,195,185,380,99.74,72.30,527
CZ071,536393,Jestřebí,205,179,384,98.97,73.35,529
CZ071,536521,Jindřichov,246,330,576,99.83,61.78,934
CZ071,536571,Kamenná,108,163,271,99.63,65.07,418
CZ071,536687,Klopina,145,203,348,100.00,71.46,487
CZ071,536733,Kolšov,205,213,418,99.52,72.59,580
CZ071,536814,Kosov,68,97,165,100.00,67.90,243
CZ071,537284,Lesnice,192,205,397,100.00,76.25,522
CZ071,537713,Leština,325,419,744,99.60,76.33,980
CZ071,539961,Libina,759,1006,1765,99.77,66.87,2647
CZ071,540161,Líšnice,104,137,241,99.59,74.46,325
CZ071,540196,Loštice,892,831,1723,99.54,72.64,2383
CZ071,540226,Loučná nad Desnou,760,450,1210,99.02,75.25,1624
CZ071,540234,Lukavice,202,268,470,99.58,66.76,707
CZ071,540331,Malá Morava,114,175,289,99.66,68.08,426
CZ071,540366,Maletín,86,135,221,99.10,68.20,327
CZ071,540471,Mohelnice,2477,2613,5090,99.55,69.46,7365
CZ071,540480,Moravičany,424,326,750,99.73,71.21,1056
CZ071,540501,Nový Malín,1095,908,2003,99.45,73.02,2758
CZ071,540510,Olšany,277,242,519,99.81,61.90,840
CZ071,540544,Oskava,315,416,731,99.86,68.67,1066
CZ071,540595,Palonín,71,145,216,99.54,78.62,276
CZ071,540609,Pavlov,157,244,401,99.75,76.28,527
CZ071,540650,Písařov,144,227,371,99.73,65.38,569
CZ071,540731,Police,53,69,122,99.19,69.89,176
CZ071,540773,Postřelmov,908,797,1705,99.30,72.57,2366
CZ071,540854,Rájec,182,141,323,99.69,81.82,396
CZ071,540862,Rapotín,895,904,1799,99.61,68.63,2633
CZ071,540871,Rohle,146,193,339,98.83,67.79,506
CZ071,540919,Rovensko,231,236,467,99.57,72.71,645
CZ071,540978,Ruda nad Moravou,759,732,1491,99.20,71.54,2101
CZ071,540986,Sobotín,294,346,640,99.53,64.95,990
CZ071,541079,Staré Město,731,610,1341,99.41,72.06,1872
CZ071,541109,Sudkov,263,344,607,99.67,65.80,927
CZ071,541125,Svébohov,131,135,266,98.52,77.36,349
CZ071,541168,Štíty,494,539,1033,99.90,65.15,1587
CZ071,541222,Úsov,263,386,649,98.93,70.39,932
CZ071,541265,Velké Losiny,905,818,1723,99.65,72.95,2370
CZ071,541354,Zábřeh,3787,3667,7454,99.59,69.81,10725
CZ071,541478,Zvole,265,240,505,99.80,78.82,642
CZ071,553191,Vikantice,15,42,57,100.00,75.00,76
CZ071,553212,Janoušov,7,33,40,95.24,89.36,47
CZ071,553221,Hrabová,207,176,383,99.74,74.56,515
CZ071,553247,Kopřivná,48,83,131,100.00,56.47,232
CZ071,553336,Třeština,123,133,256,100.00,83.66,306
CZ071,553344,Jakubovice,41,77,118,100.00,71.08,166
CZ071,553352,Postřelmůvek,87,114,201,99.50,83.13,243
CZ071,553379,Dolní Studénky,418,438,856,99.30,76.35,1129
CZ071,553387,Hraběšice,97,33,130,99.24,81.88,160
CZ071,553395,Rejchartice,51,45,96,100.00,61.15,157
CZ071,553476,Nemile,208,181,389,99.49,71.22,549
CZ071,554146,Vernířovice,141,71,212,99.53,82.56,258
CZ071,569305,Chromeč,205,133,338,100.00,73.96,457
CZ071,569372,Krchleby,41,42,83,100.00,57.64,144
CZ071,569381,Mírov,137,305,442,98.88,78.98,566
CZ071,569437,Bratrušov,171,191,362,99.18,71.01,514
CZ071,569445,Vikýřovice,758,556,1314,99.32,73.42,1802
CZ071,570095,Vyšehoří,78,77,155,100.00,78.68,197
CZ071,570117,Šléglov,30,11,41,100.00,85.42,48
CZ071,570141,Drozdov,75,133,208,99.52,77.41,270
CZ071,570281,Stavenice,30,46,76,100.00,71.03,107
CZ071,570338,Zborov,70,71,141,100.00,77.90,181
CZ064,513695,Horní Smržov,39,37,76,96.20,84.04,94
CZ064,513709,Roubanina,38,37,75,98.68,77.55,98
CZ064,530824,Velenov,69,74,143,98.62,74.74,194
CZ064,531006,Ludíkov,119,79,198,100.00,76.45,259
CZ064,534692,Újezd u Boskovic,98,167,265,99.62,70.00,380
CZ064,553875,Louka,15,28,43,100.00,75.44,57
CZ064,553883,Ústup,14,9,23,100.00,79.31,29
CZ064,554162,Crhov,55,58,113,99.12,87.02,131
CZ064,556963,Spešov,249,137,386,100.00,76.28,506
CZ064,581283,Blansko,6369,4522,10891,99.51,70.45,15543
CZ064,581291,Adamov,1283,961,2244,99.42,64.67,3490
CZ064,581313,Bedřichov,94,57,151,98.05,84.15,183
CZ064,581330,Benešov,253,179,432,99.77,77.60,558
CZ064,581356,Borotín,97,132,229,100.00,64.33,356
CZ064,581364,Bořitov,368,359,727,99.59,71.98,1017
CZ064,581372,Boskovice,3662,2752,6414,99.63,69.62,9251
CZ064,581381,Brťov-Jeneč,95,116,211,100.00,79.32,266
CZ064,581445,Bukovina,152,95,247,99.60,78.48,316
CZ064,581453,Bukovinka,240,108,348,100.00,79.82,436
CZ064,581461,Býkovice,94,68,162,100.00,83.51,194
CZ064,581470,Cetkovice,222,173,395,99.75,66.22,598
CZ064,581496,Černá Hora,738,478,1216,99.51,73.84,1655
CZ064,581500,Černovice,102,118,220,100.00,73.58,299
CZ064,581518,Deštná,48,93,141,99.30,76.76,185
CZ064,581526,Dlouhá Lhota,41,31,72,100.00,71.29,101
CZ064,581534,Chrudichromy,53,58,111,99.11,68.29,164
CZ064,581542,Doubravice nad Svitavou,424,326,750,99.73,72.10,1043
CZ064,581551,Drnovice,475,333,808,99.63,78.21,1037
CZ064,581569,Habrůvka,132,86,218,99.54,70.74,311
CZ064,581593,Hodonín,43,44,87,100.00,86.14,101
CZ064,581615,Holštejn,55,37,92,100.00,73.60,125
CZ064,581631,Horní Poříčí,72,81,153,100.00,67.70,226
CZ064,581666,Jabloňany,146,103,249,100.00,75.00,332
CZ064,581682,Jedovnice,981,711,1692,99.47,75.50,2253
CZ064,581721,Kněževes,79,31,110,100.00,78.01,141
CZ064,581739,Knínice,280,225,505,99.80,70.67,716
CZ064,581755,Kořenec,117,82,199,100.00,69.34,287
CZ064,581763,Kotvrdovice,308,211,519,99.05,73.18,716
CZ064,581771,Kozárov,38,45,83,98.81,88.42,95
CZ064,581780,Krasová,160,90,250,98.81,76.90,329
CZ064,581798,Krhov,40,56,96,100.00,76.80,125
CZ064,581801,Křetín,135,162,297,98.67,76.01,396
CZ064,581810,Křtěnov,84,50,134,100.00,76.14,176
CZ064,581828,Křtiny,314,210,524,99.62,80.06,657
CZ064,581836,Kulířov,63,47,110,99.10,77.62,143
CZ064,581844,Kunčina Ves,26,11,37,94.87,82.98,47
CZ064,581852,Kunice,71,44,115,100.00,83.33,138
CZ064,581861,Kuničky,69,92,161,100.00,75.23,214
CZ064,581879,Kunštát,949,616,1565,99.75,73.61,2133
CZ064,581887,Lazinov,69,41,110,99.10,75.51,147
CZ064,581909,Lažany,167,101,268,100.00,79.53,337
CZ064,581917,Letovice,2083,1680,3763,99.24,72.25,5250
CZ064,581925,Lhota Rapotina,127,113,240,99.17,74.46,325
CZ064,581933,Lhota u Lysic,42,45,87,100.00,75.00,116
CZ064,581941,Lhota u Olešnice,19,13,32,100.00,94.12,34
CZ064,581950,Lipovec,389,248,637,99.69,69.08,925
CZ064,581968,Lipůvka,541,281,822,99.76,74.50,1106
CZ064,581992,Lubě,48,29,77,98.72,84.78,92
CZ064,582018,Lysice,688,477,1165,99.57,77.28,1514
CZ064,582026,Makov,22,10,32,100.00,78.05,41
CZ064,582034,Malá Lhota,50,43,93,98.94,72.87,129
CZ064,582042,Malá Roudka,60,58,118,99.16,70.83,168
CZ064,582069,Míchov,52,59,111,98.23,77.40,146
CZ064,582077,Milonice,42,58,100,98.04,73.91,138
CZ064,582085,Němčice,125,144,269,100.00,70.98,379
CZ064,582107,Nýrov,88,53,141,100.00,79.66,177
CZ064,582115,Obora,90,116,206,99.52,77.82,266
CZ064,582131,Okrouhlá,211,157,368,100.00,79.14,465
CZ064,582158,Olešnice,586,371,957,99.79,72.21,1328
CZ064,582166,Olomučany,313,322,635,99.53,78.47,813
CZ064,582182,Ostrov u Macochy,373,256,629,98.59,71.56,893
CZ064,582191,Pamětice,109,53,162,100.00,75.00,216
CZ064,582204,Petrov,54,31,85,97.70,78.38,111
CZ064,582212,Petrovice,211,144,355,99.72,71.06,501
CZ064,582221,Prostřední Poříčí,51,111,162,100.00,77.51,209
CZ064,582239,Rájec-Jestřebí,1213,901,2114,99.20,72.41,2943
CZ064,582247,Ráječko,386,345,731,99.32,72.09,1021
CZ064,582271,Rozseč nad Kunštátem,227,105,332,99.70,76.73,434
CZ064,582280,Rozsíčka,38,59,97,100.00,84.35,115
CZ064,582298,Rudice,315,263,578,100.00,78.00,741
CZ064,582310,Sebranice,187,161,348,99.71,69.25,504
CZ064,582328,Senetářov,189,146,335,99.70,74.17,453
CZ064,582336,Skalice nad Svitavou,173,166,339,99.41,71.64,476
CZ064,582344,Skrchov,39,33,72,100.00,73.47,98
CZ064,582352,Sloup,400,190,590,99.16,78.08,762
CZ064,582395,Sudice,143,111,254,99.61,70.25,363
CZ064,582409,Suchý,134,137,271,98.55,74.12,371
CZ064,582417,Sulíkov,109,74,183,100.00,78.21,234
CZ064,582433,Svinošice,181,61,242,99.59,81.27,299
CZ064,582441,Svitávka,508,469,977,99.49,69.30,1417
CZ064,582468,Šebetov,186,240,426,100.00,60.14,710
CZ064,582476,Šebrov-Kateřina,298,176,474,99.58,75.20,633
CZ064,582484,Šošůvka,234,165,399,99.25,73.90,544
CZ064,582492,Štěchov,60,47,107,100.00,76.43,140
CZ064,582506,Tasovice,31,24,55,100.00,93.22,59
CZ064,582531,Uhřice,71,109,180,100.00,71.71,251
CZ064,582557,Újezd u Černé Hory,87,79,166,98.81,78.87,213
CZ064,582573,Úsobrno,102,138,240,99.59,69.25,348
CZ064,582581,Valchov,158,126,284,99.65,76.20,374
CZ064,582590,Vanovice,176,145,321,100.00,71.97,446
CZ064,582603,Vavřinec,275,236,511,99.61,72.77,705
CZ064,582611,Vážany,81,65,146,98.65,81.77,181
CZ064,582620,Stvolová,45,62,107,100.00,78.68,136
CZ064,582646,Velké Opatovice,891,983,1874,99.15,66.55,2840
CZ064,582654,Vilémovice,98,101,199,100.00,76.54,260
CZ064,582662,Vísky,77,62,139,99.29,71.43,196
CZ064,582671,Voděrady,160,152,312,99.68,73.13,428
CZ064,582689,Vranová,128,110,238,99.58,80.47,297
CZ064,582701,Vysočany,256,200,456,99.56,74.11,618
CZ064,582727,Zbraslavec,69,62,131,99.24,79.52,166
CZ064,582743,Žďár,116,112,228,99.56,68.98,332
CZ064,582751,Žďárná,216,238,454,99.78,75.33,604
CZ064,582760,Žernovník,110,60,170,100.00,84.16,202
CZ064,582778,Žerůtky,20,31,51,100.00,82.26,62
CZ064,586005,Závist,43,40,83,98.81,70.59,119
CZ064,586064,Světlá,83,74,157,100.00,78.89,199
CZ064,550973,Brno-střed,23674,8814,32488,99.61,47.78,68299
CZ064,550990,Brno-Žabovřesky,8912,3285,12197,99.44,77.00,15942
CZ064,551007,Brno-Královo Pole,10511,4112,14623,99.48,74.70,19684
CZ064,551031,Brno-sever,16877,7419,24296,99.59,71.69,34050
CZ064,551058,Brno-Židenice,7159,3494,10653,99.52,70.63,15164
CZ064,551066,Brno-Černovice,2502,1361,3863,99.51,70.76,5489
CZ064,551074,Brno-jih,2681,1585,4266,99.46,70.29,6106
CZ064,551082,Brno-Bohunice,4716,3003,7719,99.33,74.74,10407
CZ064,551091,Brno-Starý Lískovec,3920,2740,6660,99.42,69.76,9608
CZ064,551112,Brno-Nový Lískovec,3718,1989,5707,99.72,74.41,7733
CZ064,551147,Brno-Kohoutovice,4337,2609,6946,99.40,73.25,9541
CZ064,551171,Brno-Jundrov,1811,737,2548,99.22,77.05,3337
CZ064,551198,Brno-Bystrc,8846,4363,13209,99.55,72.43,18323
CZ064,551210,Brno-Kníničky,460,180,640,99.38,78.54,820
CZ064,551228,Brno-Komín,3133,1313,4446,99.44,78.05,5731
CZ064,551236,Brno-Medlánky,2354,773,3127,99.43,79.72,3945
CZ064,551244,Brno-Řečkovice a Mokrá Hora,5746,2619,8365,99.42,75.94,11135
CZ064,551252,Brno-Maloměřice a Obřany,2179,976,3155,99.43,73.25,4333
CZ064,551279,Brno-Vinohrady,4229,2657,6886,99.60,72.12,9595
CZ064,551287,Brno-Líšeň,9006,5136,14142,99.52,73.85,19260
CZ064,551295,Brno-Slatina,3423,1785,5208,99.54,73.55,7116
CZ064,551309,Brno-Tuřany,1987,1083,3070,99.38,74.82,4130
CZ064,551317,Brno-Chrlice,1247,620,1867,99.63,74.70,2510
CZ064,551325,Brno-Bosonohy,1025,425,1450,99.45,78.01,1869
CZ064,551368,Brno-Žebětín,2318,775,3093,99.36,77.26,4029
CZ064,551376,Brno-Ivanovice,897,279,1176,99.41,83.03,1426
CZ064,551406,Brno-Jehnice,500,189,689,99.57,82.13,845
CZ064,551422,Brno-Ořešín,243,128,371,98.67,80.86,465
CZ064,551431,Brno-Útěchov,399,145,544,99.82,83.98,649
CZ064,582786,Brno,138810,64594,203404,99.51,67.85,301541
CZ064,506699,Otmarov,161,76,237,100.00,84.64,280
CZ064,545295,Skalička,62,36,98,100.00,76.56,128
CZ064,549738,Ponětovice,164,78,242,99.59,75.94,320
CZ064,549746,Předklášteří,418,374,792,99.75,71.34,1113
CZ064,549789,Říčky,158,99,257,99.61,79.63,324
CZ064,549894,Skryje,9,33,42,100.00,72.41,58
CZ064,549908,Újezd u Tišnova,51,27,78,100.00,67.83,115
CZ064,550272,Cvrčovice,194,200,394,100.00,74.90,526
CZ064,581321,Běleč,64,53,117,100.00,75.97,154
CZ064,581402,Brumov,74,98,172,100.00,82.30,209
CZ064,581429,Březina,411,194,605,99.67,77.92,779
CZ064,581437,Bukovice,33,27,60,100.00,86.96,69
CZ064,581577,Hluboké Dvory,26,29,55,96.49,71.25,80
CZ064,581976,Lomnice,419,364,783,99.37,68.82,1145
CZ064,582123,Ochoz u Tišnova,51,31,82,100.00,88.17,93
CZ064,582174,Osiky,53,38,91,98.91,85.98,107
CZ064,582255,Rašov,76,70,146,100.00,73.74,198
CZ064,582263,Rohozec,93,46,139,100.00,75.96,183
CZ064,582379,Strhaře,47,41,88,100.00,80.00,110
CZ064,582450,Synalov,38,37,75,100.00,78.13,96
CZ064,582565,Unín,85,63,148,100.00,75.13,197
CZ064,582735,Zhoř,31,14,45,100.00,81.82,55
CZ064,582794,Babice nad Svitavou,574,213,787,99.24,80.75,982
CZ064,582808,Babice u Rosic,262,182,444,99.55,77.30,577
CZ064,582824,Bílovice nad Svitavou,1603,576,2179,99.59,80.03,2734
CZ064,582832,Biskoupky,50,59,109,99.09,69.62,158
CZ064,582841,Blažovice,510,216,726,99.86,82.61,880
CZ064,582859,Blučina,691,551,1242,99.60,73.18,1704
CZ064,582875,Braníškov,76,44,120,98.36,76.73,159
CZ064,582883,Bratčice,206,187,393,99.75,76.95,512
CZ064,582891,Březina,131,86,217,100.00,74.57,291
CZ064,582913,Čebín,656,401,1057,99.53,76.02,1397
CZ064,582921,Česká,449,181,630,99.37,79.55,797
CZ064,582930,Čučice,114,136,250,99.60,69.53,361
CZ064,582948,Deblín,375,247,622,99.36,73.91,847
CZ064,582956,Dolní Kounice,721,595,1316,99.47,68.48,1932
CZ064,582964,Domašov,267,126,393,99.75,76.50,515
CZ064,582972,Drásov,740,358,1098,100.00,76.30,1439
CZ064,582999,Hajany,249,128,377,99.74,77.62,487
CZ064,583014,Heroltice,79,64,143,100.00,75.66,189
CZ064,583022,Hlína,118,69,187,99.47,76.21,248
CZ064,583031,Holasice,447,262,709,99.72,73.55,968
CZ064,583057,Hostěnice,322,124,446,99.55,76.84,583
CZ064,583065,Hradčany,250,144,394,99.49,75.29,526
CZ064,583081,Hrušovany u Brna,1106,790,1896,99.63,71.43,2664
CZ064,583090,Hvozdec,158,57,215,99.54,78.83,274
CZ064,583111,Chudčice,375,214,589,99.83,78.88,748
CZ064,583120,Ivančice,2989,2519,5508,99.51,70.08,7901
CZ064,583154,Javůrek,104,88,192,98.97,69.53,279
CZ064,583171,Jinačovice,373,121,494,99.80,82.64,599
CZ064,583189,Jiříkovice,450,140,590,99.66,81.10,730
CZ064,583197,Kanice,469,148,617,100.00,81.72,755
CZ064,583201,Ketkovice,166,164,330,99.10,69.81,477
CZ064,583219,Kobylnice,520,170,690,99.71,79.82,867
CZ064,583227,Kovalovice,270,129,399,98.52,77.59,522
CZ064,583235,Kratochvilka,121,164,285,99.65,75.46,379
CZ064,583243,Kupařovice,90,94,184,99.46,72.83,254
CZ064,583251,Kuřim,3964,2257,6221,99.50,74.63,8381
CZ064,583260,Lažánky,270,167,437,99.54,77.19,570
CZ064,583278,Ledce,83,59,142,100.00,78.02,182
CZ064,583286,Lelekovice,861,307,1168,99.66,79.28,1482
CZ064,583294,Lesní Hluboké,109,60,169,100.00,85.79,197
CZ064,583308,Litostrov,53,30,83,100.00,83.00,100
CZ064,583316,Lomnička,205,110,315,100.00,75.18,419
CZ064,583324,Lukovany,208,150,358,98.62,71.04,511
CZ064,583332,Malešovice,225,182,407,99.27,73.87,555
CZ064,583341,Malhostovice,368,216,584,100.00,77.25,756
CZ064,583359,Maršov,163,147,310,99.04,78.05,401
CZ064,583367,Medlov,237,258,495,100.00,74.81,663
CZ064,583375,Mělčany,168,136,304,100.00,81.28,374
CZ064,583383,Měnín,564,429,993,99.60,71.18,1402
CZ064,583391,Modřice,1750,943,2693,99.45,73.92,3665
CZ064,583405,Mokrá-Horákov,1038,570,1608,99.75,73.93,2183
CZ064,583413,Moravany,1178,556,1734,99.20,76.97,2271
CZ064,583421,Moravské Bránice,337,226,563,100.00,75.98,741
CZ064,583430,Moravské Knínice,445,198,643,99.69,80.02,806
CZ064,583448,Moutnice,443,239,682,99.85,74.56,916
CZ064,583456,Nebovidy,320,152,472,98.95,76.81,621
CZ064,583464,Nelepeč-Žernůvka,40,17,57,100.00,77.03,74
CZ064,583472,Němčičky,118,77,195,98.48,77.65,255
CZ064,583481,Neslovice,335,202,537,100.00,71.98,746
CZ064,583499,Nesvačilka,106,85,191,99.48,75.59,254
CZ064,583502,Nová Ves,214,256,470,100.00,73.90,636
CZ064,583511,Nové Bránice,262,174,436,99.77,78.18,559
CZ064,583529,Odrovice,35,100,135,100.00,75.00,180
CZ064,583537,Ochoz u Brna,595,278,873,99.77,76.22,1148
CZ064,583545,Omice,313,165,478,99.58,74.65,643
CZ064,583553,Opatovice,347,285,632,99.68,74.91,849
CZ064,583561,Ořechov,987,619,1606,99.44,76.69,2106
CZ064,583588,Oslavany,1131,1396,2527,99.65,67.30,3768
CZ064,583596,Ostopovice,699,327,1026,99.71,78.25,1315
CZ064,583600,Ostrovačice,307,173,480,100.00,75.87,634
CZ064,583634,Podolí,593,244,837,99.64,77.13,1089
CZ064,583651,Popovice,143,62,205,100.00,78.54,261
CZ064,583669,Popůvky,670,250,920,99.46,77.10,1201
CZ064,583677,Pozořice,879,454,1333,99.63,76.68,1745
CZ064,583685,Prace,354,178,532,99.44,74.00,723
CZ064,583693,Pravlov,187,187,374,100.00,72.76,514
CZ064,583707,Prštice,255,275,530,99.81,70.61,752
CZ064,583715,Příbram na Moravě,185,188,373,99.20,77.37,486
CZ064,583723,Přibyslavice,173,120,293,99.32,71.78,411
CZ064,583731,Přísnotice,277,251,528,99.62,76.37,694
CZ064,583740,Radostice,241,212,453,99.78,75.42,602
CZ064,583758,Rajhrad,1371,800,2171,99.50,75.37,2895
CZ064,583766,Rajhradice,481,360,841,99.41,73.89,1145
CZ064,583774,Rebešovice,368,223,591,99.49,77.55,766
CZ064,583782,Rosice,2104,1423,3527,99.60,72.52,4883
CZ064,583791,Rozdrojovice,470,171,641,99.38,79.36,814
CZ064,583804,Rudka,130,98,228,100.00,74.75,305
CZ064,583821,Řícmanice,296,176,472,99.37,76.49,621
CZ064,583839,Říčany,754,475,1229,99.27,77.04,1607
CZ064,583847,Sentice,235,156,391,98.74,78.88,502
CZ064,583855,Silůvky,303,221,524,99.05,80.40,658
CZ064,583863,Sivice,426,194,620,98.73,79.29,792
CZ064,583880,Sobotovice,191,128,319,100.00,70.26,454
CZ064,583898,Sokolnice,846,422,1268,99.22,73.53,1738
CZ064,583901,Stanoviště,136,74,210,98.59,72.70,293
CZ064,583910,Střelice,1333,496,1829,99.56,77.81,2361
CZ064,583928,Svatoslav,105,134,239,100.00,68.48,349
CZ064,583936,Syrovice,720,306,1026,99.71,77.66,1325
CZ064,583944,Šerkovice,125,76,201,99.50,77.39,261
CZ064,583952,Šlapanice,2958,1432,4390,99.55,76.05,5803
CZ064,583961,Štěpánovice,194,129,323,99.69,79.22,409
CZ064,583979,Telnice,654,311,965,99.38,77.37,1255
CZ064,583987,Tetčice,384,250,634,99.69,74.97,851
CZ064,583995,Těšany,376,289,665,99.55,68.09,981
CZ064,584002,Tišnov,3176,1780,4956,99.60,72.23,6893
CZ064,584011,Trboušany,154,80,234,99.57,79.39,296
CZ064,584029,Troubsko,923,435,1358,99.41,72.66,1880
CZ064,584037,Tvarožná,570,240,810,98.78,81.27,1009
CZ064,584045,Újezd u Brna,1250,695,1945,99.34,77.35,2534
CZ064,584053,Újezd u Rosic,91,71,162,100.00,72.97,222
CZ064,584061,Unkovice,254,187,441,100.00,73.99,596
CZ064,584070,Úsuší,57,37,94,100.00,85.45,110
CZ064,584096,Velatice,350,110,460,99.14,82.12,565
CZ064,584100,Veverská Bítýška,1183,616,1799,99.45,72.27,2503
CZ064,584118,Veverské Knínice,335,221,556,100.00,74.93,742
CZ064,584126,Viničné Šumice,549,248,797,99.50,78.22,1024
CZ064,584134,Vohančice,88,44,132,98.51,85.90,156
CZ064,584142,Vojkovice,471,262,733,99.59,77.56,949
CZ064,584151,Vranov,379,149,528,99.81,81.89,646
CZ064,584169,Všechovice,105,52,157,98.13,78.82,203
CZ064,584177,Vysoké Popovice,243,182,425,99.30,73.54,582
CZ064,584185,Zakřany,225,194,419,99.52,68.68,613
CZ064,584193,Zálesná Zhoř,21,16,37,100.00,72.55,51
CZ064,584207,Zastávka,655,641,1296,99.54,67.51,1933
CZ064,584215,Zbraslav,431,324,755,100.00,77.06,981
CZ064,584223,Zbýšov,789,1063,1852,99.68,64.20,2894
CZ064,584231,Žabčice,511,437,948,99.79,74.22,1280
CZ064,584240,Žatčany,325,168,493,99.40,71.41,696
CZ064,584266,Želešice,634,354,988,99.40,74.01,1343
CZ064,584274,Železné,239,85,324,99.69,77.38,420
CZ064,584282,Židlochovice,1221,805,2026,99.66,73.42,2784
CZ064,584517,Ivaň,248,201,449,100.00,73.61,610
CZ064,584720,Nosislav,474,321,795,99.62,75.07,1063
CZ064,584762,Pasohlávky,181,241,422,99.53,71.74,591
CZ064,584801,Pohořelice,1398,1446,2844,99.72,69.90,4083
CZ064,584843,Přibice,321,274,595,99.83,70.78,842
CZ064,585025,Vlasatice,190,267,457,99.13,66.43,694
CZ064,585033,Vranovice,822,519,1341,99.78,70.89,1896
CZ064,587907,Katov,95,65,160,99.38,83.85,192
CZ064,591661,Senorady,119,123,242,99.59,75.62,324
CZ064,593834,Branišovice,190,156,346,99.14,71.81,486
CZ064,594377,Loděnice,132,172,304,99.67,73.32,416
CZ064,594903,Šumice,73,92,165,100.00,71.74,230
CZ064,594962,Troskotovice,163,252,415,99.76,72.85,571
CZ064,595314,Borač,137,78,215,99.08,79.20,274
CZ064,595331,Borovník,43,26,69,100.00,75.00,92
CZ064,595446,Černvír,64,47,111,99.11,91.80,122
CZ064,595527,Dolní Loučky,470,318,788,99.87,75.14,1050
CZ064,595551,Doubravník,261,229,490,99.59,76.16,646
CZ064,595560,Drahonín,36,31,67,100.00,75.28,89
CZ064,595667,Horní Loučky,82,89,171,97.71,72.92,240
CZ064,595837,Kaly,85,69,154,99.35,71.10,218
CZ064,595934,Křižínkov,81,46,127,99.22,72.73,176
CZ064,595985,Kuřimská Nová Ves,45,39,84,100.00,75.00,112
CZ064,595993,Kuřimské Jestřabí,76,23,99,100.00,73.88,134
CZ064,596078,Lubné,33,7,40,100.00,88.89,45
CZ064,596175,Nedvědice,438,358,796,98.76,75.14,1074
CZ064,596191,Níhov,119,41,160,99.38,85.64,188
CZ064,596302,Olší,135,74,209,100.00,79.77,262
CZ064,596400,Pernštejnské Jestřabí,83,34,117,100.00,76.47,153
CZ064,596582,Rojetín,21,22,43,100.00,70.49,61
CZ064,596698,Řikonín,24,10,34,100.00,85.00,40
CZ064,596892,Tišnovská Nová Ves,54,10,64,100.00,77.11,83
CZ064,597104,Vratislávka,30,20,50,98.04,72.86,70
CZ064,597171,Žďárec,170,66,236,100.00,79.19,298
CZ064,550256,Kašnice,60,69,129,100.00,73.71,175
CZ064,555282,Kurdějov,162,125,287,99.65,79.78,361
CZ064,558443,Ladná,337,394,731,99.59,73.18,1003
CZ064,584291,Břeclav,6727,6303,13030,99.56,66.77,19613
CZ064,584304,Bavory,144,102,246,100.00,74.10,332
CZ064,584321,Boleradice,359,174,533,99.81,72.75,734
CZ064,584339,Borkovany,228,232,460,99.78,70.06,658
CZ064,584347,Bořetice,510,309,819,99.39,79.77,1033
CZ064,584355,Brod nad Dyjí,139,154,293,100.00,62.61,468
CZ064,584363,Brumovice,286,242,528,99.62,68.74,771
CZ064,584371,Březí,505,461,966,99.59,72.82,1332
CZ064,584380,Bulhary,145,283,428,99.53,71.43,602
CZ064,584401,Diváky,128,184,312,99.68,78.25,400
CZ064,584410,Dobré Pole,107,143,250,100.00,69.44,360
CZ064,584428,Dolní Dunajovice,528,440,968,99.18,69.59,1404
CZ064,584436,Dolní Věstonice,92,101,193,99.48,72.93,266
CZ064,584444,Drnholec,437,526,963,99.69,67.13,1439
CZ064,584452,Hlohovec,353,348,701,99.86,69.57,1009
CZ064,584461,Horní Bojanovice,217,222,439,99.32,79.78,554
CZ064,584479,Horní Věstonice,170,123,293,99.32,71.43,413
CZ064,584487,Hrušky,437,470,907,99.56,70.97,1285
CZ064,584495,Hustopeče,1980,1451,3431,99.39,71.89,4803
CZ064,584525,Jevišovka,119,162,281,99.65,52.81,534
CZ064,584541,Klentnice,124,130,254,99.61,64.39,396
CZ064,584550,Klobouky u Brna,740,648,1388,99.57,72.68,1918
CZ064,584568,Kobylí,663,521,1184,99.50,72.08,1651
CZ064,584576,Kostice,443,608,1051,99.62,69.36,1521
CZ064,584584,Krumvíř,423,267,690,99.86,71.61,965
CZ064,584592,Křepice,397,343,740,99.33,71.16,1047
CZ064,584622,Lanžhot,948,1033,1981,99.60,67.45,2949
CZ064,584631,Lednice,638,674,1312,99.85,73.61,1785
CZ064,584649,Mikulov,2529,1782,4311,99.65,69.78,6201
CZ064,584657,Milovice,128,133,261,100.00,69.23,377
CZ064,584665,Moravská Nová Ves,737,671,1408,99.58,69.79,2026
CZ064,584673,Moravský Žižkov,498,295,793,98.51,67.99,1184
CZ064,584681,Morkůvky,191,102,293,99.66,75.58,389
CZ064,584703,Němčičky,262,169,431,99.31,76.41,568
CZ064,584711,Nikolčice,278,183,461,99.57,73.14,633
CZ064,584746,Novosedly,324,331,655,99.39,67.04,983
CZ064,584754,Nový Přerov,64,99,163,99.39,58.16,282
CZ064,584771,Pavlov,181,148,329,98.80,73.51,453
CZ064,584789,Perná,290,185,475,100.00,74.45,638
CZ064,584797,Podivín,921,728,1649,99.64,71.65,2310
CZ064,584819,Popice,292,288,580,98.98,76.60,765
CZ064,584835,Pouzdřany,208,201,409,100.00,64.93,633
CZ064,584851,Přítluky,189,281,470,99.37,73.68,642
CZ064,584860,Rakvice,696,480,1176,99.58,68.76,1719
CZ064,584878,Sedlec,196,281,477,99.79,68.78,695
CZ064,584894,Starovice,231,289,520,99.62,71.90,726
CZ064,584908,Starovičky,211,257,468,99.36,68.26,690
CZ064,584916,Strachotín,204,245,449,99.78,69.88,644
CZ064,584924,Šakvice,365,406,771,99.74,65.23,1185
CZ064,584932,Šitbořice,746,497,1243,99.60,76.72,1628
CZ064,584941,Tvrdonice,563,573,1136,99.82,69.60,1635
CZ064,584959,Týnec,289,304,593,99.33,70.65,845
CZ064,584967,Uherčice,362,264,626,99.68,74.32,845
CZ064,584975,Valtice,1065,927,1992,99.70,68.80,2904
CZ064,584983,Velké Bílovice,1625,663,2288,99.31,75.67,3045
CZ064,584991,Velké Hostěrádky,168,114,282,99.65,74.67,379
CZ064,585009,Velké Němčice,655,417,1072,99.81,76.60,1402
CZ064,585017,Velké Pavlovice,1143,673,1816,99.73,74.36,2449
CZ064,585041,Vrbice,377,280,657,99.55,77.01,857
CZ064,585050,Zaječí,447,390,837,99.76,66.88,1256
CZ064,586021,Hodonín,5969,6269,12238,99.54,63.35,19429
CZ064,586030,Archlebov,257,217,474,99.58,69.69,683
CZ064,586048,Blatnice pod Svatým Antonínkem,719,445,1164,99.15,72.74,1614
CZ064,586056,Blatnička,140,114,254,99.61,74.13,344
CZ064,586072,Bukovany,207,214,421,100.00,70.88,594
CZ064,586081,Bzenec,1176,1131,2307,98.93,68.10,3429
CZ064,586099,Čejč,436,341,777,99.36,76.37,1024
CZ064,586102,Čejkovice,900,544,1444,99.86,73.40,1970
CZ064,586111,Čeložnice,129,125,254,100.00,72.36,351
CZ064,586129,Dambořice,440,377,817,99.15,71.40,1154
CZ064,586137,Dolní Bojanovice,1199,568,1767,99.05,76.37,2336
CZ064,586145,Domanín,254,305,559,99.64,69.60,806
CZ064,586153,Dražůvky,78,73,151,99.34,68.47,222
CZ064,586161,Dubňany,1588,1930,3518,99.74,69.25,5093
CZ064,586170,Hovorany,738,537,1275,99.69,72.88,1755
CZ064,586188,Hroznová Lhota,342,383,725,99.59,76.96,946
CZ064,586196,Hrubá Vrbka,162,153,315,99.37,68.47,463
CZ064,586200,Hýsly,101,112,213,99.07,66.77,322
CZ064,586218,Javorník,178,201,379,99.48,70.35,543
CZ064,586226,Ježov,210,207,417,99.76,74.11,564
CZ064,586234,Josefov,169,116,285,99.65,80.79,354
CZ064,586242,Karlín,71,57,128,98.46,77.84,167
CZ064,586251,Kelčany,69,68,137,98.56,69.85,199
CZ064,586269,Kněždub,239,348,587,99.83,66.74,881
CZ064,586277,Kostelec,305,209,514,99.23,75.18,689
CZ064,586285,Kozojídky,169,153,322,99.38,75.35,430
CZ064,586293,Kuželov,121,119,240,99.17,74.92,323
CZ064,586307,Kyjov,3499,2722,6221,99.62,70.04,8916
CZ064,586315,Labuty,52,58,110,99.10,76.03,146
CZ064,586323,Lipov,442,398,840,99.88,72.00,1168
CZ064,586331,Louka,253,328,581,99.49,76.84,760
CZ064,586340,Lovčice,261,242,503,99.80,75.56,667
CZ064,586358,Lužice,821,716,1537,99.42,67.75,2285
CZ064,586366,Malá Vrbka,70,54,124,100.00,86.11,144
CZ064,586374,Mikulčice,561,543,1104,99.82,71.11,1561
CZ064,586382,Milotice,592,448,1040,99.52,70.85,1475
CZ064,586391,Moravany,225,208,433,99.54,72.38,601
CZ064,586404,Moravský Písek,527,650,1177,99.49,71.83,1654
CZ064,586412,Mutěnice,1190,854,2044,99.56,70.70,2904
CZ064,586421,Násedlovice,298,209,507,99.80,73.38,695
CZ064,586439,Nechvalín,90,112,202,98.06,73.57,280
CZ064,586447,Nenkovice,159,118,277,99.64,71.47,389
CZ064,586455,Nová Lhota,121,195,316,100.00,62.08,509
CZ064,586463,Nový Poddvorov,64,75,139,100.00,77.65,179
CZ064,586471,Ostrovánky,64,70,134,100.00,73.22,183
CZ064,586480,Petrov,359,371,730,99.46,68.28,1075
CZ064,586498,Prušánky,700,485,1185,99.33,68.88,1732
CZ064,586501,Radějov,248,237,485,99.59,70.99,686
CZ064,586510,Ratíškovice,1163,1187,2350,99.75,72.90,3233
CZ064,586528,Rohatec,921,1027,1948,99.69,68.55,2852
CZ064,586536,Skalka,40,61,101,100.00,72.14,140
CZ064,586544,Skoronice,191,111,302,99.67,72.14,420
CZ064,586552,Sobůlky,230,257,487,99.80,71.24,685
CZ064,586561,Starý Poddvorov,251,289,540,99.82,69.27,781
CZ064,586579,Stavěšice,93,128,221,99.55,72.79,305
CZ064,586587,Strážnice,1984,1142,3126,99.40,72.54,4341
CZ064,586595,Strážovice,181,175,356,99.44,75.69,473
CZ064,586609,Sudoměřice,322,332,654,99.39,68.54,960
CZ064,586617,Suchov,89,174,263,99.62,66.67,396
CZ064,586625,Svatobořice-Mistřín,1071,966,2037,99.51,72.39,2829
CZ064,586633,Syrovín,111,104,215,98.62,76.22,286
CZ064,586641,Šardice,582,694,1276,99.84,71.24,1794
CZ064,586650,Tasov,111,192,303,100.00,70.63,429
CZ064,586668,Těmice,266,245,511,99.61,71.65,716
CZ064,586676,Terezín,118,117,235,99.16,72.92,325
CZ064,586684,Tvarožná Lhota,278,261,539,99.63,73.21,739
CZ064,586692,Uhřice,244,166,410,100.00,72.06,569
CZ064,586706,Vacenovice,677,598,1275,99.84,74.29,1719
CZ064,586714,Velká nad Veličkou,768,861,1629,99.33,69.64,2355
CZ064,586722,Veselí nad Moravou,2905,2919,5824,99.54,66.62,8786
CZ064,586731,Věteřov,190,116,306,99.67,70.09,438
CZ064,586749,Vlkoš,304,302,606,99.51,73.11,833
CZ064,586757,Vnorovy,906,748,1654,99.58,70.59,2353
CZ064,586765,Vracov,1253,1215,2468,99.60,67.70,3660
CZ064,586773,Vřesovice,167,163,330,99.40,68.31,486
CZ064,586781,Žádovice,193,203,396,98.75,66.72,601
CZ064,586790,Žarošice,396,216,612,99.35,71.96,856
CZ064,586803,Ždánice,763,670,1433,99.38,70.77,2039
CZ064,586811,Želetice,179,124,303,99.34,70.44,433
CZ064,586820,Žeravice,295,321,616,99.19,72.72,854
CZ064,586838,Žeraviny,52,61,113,100.00,70.19,161
CZ064,593354,Mouchnice,64,112,176,100.00,69.02,255
CZ064,550108,Kozlany,96,121,217,99.54,68.77,317
CZ064,550132,Olšany,232,140,372,99.73,76.28,489
CZ064,550141,Medlovice,112,124,236,99.58,78.74,301
CZ064,550175,Podomí,155,116,271,98.91,75.48,363
CZ064,550191,Uhřice,73,64,137,100.00,65.55,209
CZ064,550213,Heršpice,308,189,497,99.40,77.28,647
CZ064,550795,Podbřežice,70,76,146,100.00,68.87,212
CZ064,550825,Holubice,605,295,900,99.89,77.87,1157
CZ064,553972,Rybníček,63,95,158,100.00,77.45,204
CZ064,554898,Rostěnice-Zvonovice,141,145,286,100.00,67.14,426
CZ064,557048,Mouřínov,106,148,254,100.00,65.72,388
CZ064,592889,Vyškov,6009,5157,11166,99.38,69.62,16141
CZ064,592897,Bohaté Málkovice,63,66,129,100.00,64.50,200
CZ064,592901,Bohdalice-Pavlovice,249,301,550,99.64,74.90,737
CZ064,592919,Bošovice,386,286,672,99.41,71.84,941
CZ064,592927,Brankovice,212,281,493,98.40,70.17,714
CZ064,592943,Bučovice,1854,1705,3559,99.66,68.53,5212
CZ064,592978,Dětkovice,69,68,137,100.00,64.93,211
CZ064,592986,Dobročkovice,74,55,129,100.00,72.88,177
CZ064,592994,Dražovice,315,230,545,99.45,74.97,731
CZ064,593001,Drnovice,740,674,1414,99.37,75.46,1899
CZ064,593010,Drysice,124,170,294,100.00,62.77,470
CZ064,593028,Habrovany,272,230,502,98.82,71.95,706
CZ064,593036,Hlubočany,132,164,296,99.33,74.87,398
CZ064,593044,Hodějice,330,293,623,99.68,75.03,833
CZ064,593052,Hostěrádky-Rešov,306,199,505,99.21,75.30,676
CZ064,593061,Hoštice-Heroltice,159,190,349,99.71,71.87,487
CZ064,593079,Hrušky,247,180,427,100.00,70.70,604
CZ064,593087,Hvězdlice,105,191,296,100.00,64.01,464
CZ064,593095,Chvalkovice,55,86,141,99.30,66.67,213
CZ064,593117,Ivanovice na Hané,685,867,1552,99.49,67.27,2319
CZ064,593125,Ježkovice,109,93,202,100.00,66.89,302
CZ064,593141,Kobeřice u Brna,283,131,414,100.00,73.93,560
CZ064,593150,Kojátky,73,103,176,99.44,62.32,284
CZ064,593168,Komořany,247,182,429,100.00,72.34,593
CZ064,593184,Kožušice,33,37,70,98.59,73.96,96
CZ064,593192,Krásensko,175,86,261,100.00,74.64,351
CZ064,593214,Křenovice,757,417,1174,99.49,76.54,1543
CZ064,593222,Křižanovice,234,218,452,99.56,70.72,642
CZ064,593231,Křižanovice u Vyškova,41,45,86,100.00,76.11,113
CZ064,593249,Kučerov,125,134,259,98.85,71.47,368
CZ064,593257,Letonice,373,377,750,99.47,68.05,1108
CZ064,593265,Lovčičky,258,152,410,99.03,76.24,543
CZ064,593273,Luleč,319,239,558,99.29,73.27,767
CZ064,593281,Lysovice,46,111,157,98.74,71.30,223
CZ064,593290,Malínky,30,38,68,100.00,64.15,106
CZ064,593320,Milešovice,242,170,412,99.76,74.28,556
CZ064,593338,Milonice,101,123,224,99.12,78.20,289
CZ064,593346,Moravské Málkovice,137,182,319,99.69,70.80,452
CZ064,593371,Němčany,279,177,456,98.92,77.35,596
CZ064,593389,Nemochovice,59,106,165,99.40,66.94,248
CZ064,593397,Nemojany,248,196,444,99.55,73.11,610
CZ064,593401,Nemotice,97,133,230,99.57,69.79,331
CZ064,593419,Nesovice,293,289,582,99.49,66.70,877
CZ064,593427,Nevojice,112,142,254,100.00,76.97,330
CZ064,593435,Nížkovice,252,171,423,99.53,70.02,607
CZ064,593443,Nové Sady,23,37,60,96.77,80.52,77
CZ064,593460,Orlovice,89,93,182,99.45,75.00,244
CZ064,593478,Otnice,477,418,895,99.67,73.61,1220
CZ064,593486,Podivice,35,75,110,100.00,79.14,139
CZ064,593494,Prusy-Boškůvky,176,202,378,99.74,73.45,516
CZ064,593508,Pustiměř,593,488,1081,99.45,75.77,1436
CZ064,593516,Račice-Pístovice,370,348,718,99.31,75.00,964
CZ064,593524,Radslavice,124,118,242,99.59,72.97,333
CZ064,593532,Rašovice,211,157,368,99.19,71.07,522
CZ064,593559,Rousínov,1821,1287,3108,99.55,72.85,4288
CZ064,593567,Ruprechtov,201,151,352,99.72,71.46,494
CZ064,593583,Slavkov u Brna,2520,1255,3775,99.76,71.06,5325
CZ064,593591,Snovídky,61,117,178,99.44,68.58,261
CZ064,593605,Studnice,125,162,287,99.31,70.32,411
CZ064,593613,Šaratice,353,225,578,99.66,70.47,823
CZ064,593621,Švábenice,295,304,599,99.83,76.82,781
CZ064,593630,Topolany,99,102,201,100.00,73.09,275
CZ064,593648,Tučapy,144,171,315,99.68,68.55,461
CZ064,593656,Vážany,129,109,238,100.00,68.79,346
CZ064,593664,Vážany nad Litavou,247,191,438,99.32,77.23,571
CZ064,593681,Velešovice,419,282,701,99.57,72.73,968
CZ064,593699,Zbýšov,265,136,401,99.26,78.45,515
CZ064,593702,Zelená Hora,80,97,177,98.33,77.25,233
CZ064,545325,Velký Karlov,77,142,219,100.00,66.97,327
CZ064,546941,Dobšice,632,693,1325,99.25,72.26,1849
CZ064,550019,Vracovice,35,72,107,100.00,66.46,161
CZ064,550051,Plenkovice,106,131,237,99.58,78.03,305
CZ064,550078,Přeskače,55,11,66,100.00,79.52,83
CZ064,550086,Křídlůvky,47,95,142,100.00,73.58,193
CZ064,550841,Jiřice u Moravských Budějovic,17,12,29,100.00,64.44,45
CZ064,555231,Suchohrdly,386,377,763,99.22,73.45,1047
CZ064,587729,Nový Šaldorf-Sedlešovice,545,380,925,99.78,72.42,1280
CZ064,593711,Znojmo,8777,9006,17783,99.51,67.53,26476
CZ064,593729,Bantice,96,84,180,98.90,79.48,229
CZ064,593737,Běhařovice,79,147,226,100.00,72.20,313
CZ064,593745,Bezkov,61,63,124,97.64,79.87,159
CZ064,593753,Bítov,47,32,79,100.00,71.82,110
CZ064,593761,Blanné,19,34,53,100.00,70.67,75
CZ064,593770,Blížkovice,327,401,728,99.86,75.62,964
CZ064,593788,Bohutice,168,237,405,99.75,74.82,544
CZ064,593796,Bojanovice,24,75,99,100.00,66.89,148
CZ064,593800,Borotice,47,172,219,99.55,66.87,329
CZ064,593818,Boskovštejn,41,46,87,100.00,70.16,124
CZ064,593826,Božice,327,436,763,99.48,63.55,1207
CZ064,593842,Břežany,113,275,388,99.74,57.37,678
CZ064,593851,Citonice,166,188,354,99.72,77.01,461
CZ064,593869,Ctidružice,78,101,179,100.00,72.18,248
CZ064,593877,Čejkovice,51,103,154,100.00,77.78,198
CZ064,593885,Čermákovice,38,33,71,100.00,81.61,87
CZ064,593893,Černín,24,64,88,96.70,77.12,118
CZ064,593907,Damnice,78,154,232,99.57,72.81,320
CZ064,593923,Dobelice,75,88,163,99.39,74.21,221
CZ064,593931,Dobřínsko,130,110,240,98.77,75.70,321
CZ064,593958,Dolenice,48,47,95,100.00,86.36,110
CZ064,593966,Dolní Dubňany,170,116,286,100.00,77.72,368
CZ064,593974,Dyjákovice,177,271,448,99.56,67.37,668
CZ064,593982,Dyjákovičky,142,164,306,100.00,69.39,441
CZ064,593991,Dyje,116,162,278,98.23,72.19,392
CZ064,594008,Džbánice,30,64,94,100.00,77.69,121
CZ064,594016,Grešlové Mýto,51,74,125,100.00,76.69,163
CZ064,594024,Havraníky,87,81,168,100.00,69.14,243
CZ064,594032,Hevlín,258,457,715,99.58,65.63,1094
CZ064,594041,Hluboké Mašůvky,196,286,482,98.77,73.42,666
CZ064,594059,Hnanice,102,113,215,100.00,74.39,289
CZ064,594067,Hodonice,430,497,927,100.00,67.61,1371
CZ064,594075,Horní Břečkov,49,80,129,100.00,61.43,210
CZ064,594083,Horní Dubňany,60,111,171,98.84,75.88,228
CZ064,594091,Horní Dunajovice,124,236,360,100.00,71.43,504
CZ064,594105,Horní Kounice,80,90,170,99.42,75.00,228
CZ064,594113,Hostěradice,322,552,874,99.43,66.95,1313
CZ064,594121,Hostim,83,124,207,100.00,60.88,340
CZ064,594130,Hrabětice,123,314,437,100.00,61.20,714
CZ064,594148,Hrádek,140,331,471,99.79,65.56,720
CZ064,594156,Hrušovany nad Jevišovkou,713,1001,1714,99.65,66.86,2574
CZ064,594164,Chvalatice,27,43,70,100.00,76.09,92
CZ064,594172,Chvalovice,153,214,367,98.92,75.71,490
CZ064,594181,Jamolice,122,127,249,99.20,69.34,362
CZ064,594199,Jaroslavice,264,353,617,99.84,62.42,990
CZ064,594202,Jevišovice,267,369,636,99.07,69.63,922
CZ064,594211,Jezeřany-Maršovice,253,178,431,100.00,70.89,608
CZ064,594229,Jiřice u Miroslavi,122,162,284,99.65,76.61,372
CZ064,594237,Kadov,23,54,77,100.00,65.81,117
CZ064,594253,Korolupy,36,56,92,100.00,71.32,129
CZ064,594261,Kravsko,122,213,335,100.00,73.95,453
CZ064,594270,Krhovice,94,209,303,99.34,66.45,459
CZ064,594288,Křepice,43,23,66,100.00,71.74,92
CZ064,594296,Kubšice,50,36,86,100.00,71.07,121
CZ064,594300,Kuchařovice,266,276,542,99.82,73.58,738
CZ064,594318,Kyjovice,32,65,97,100.00,77.78,126
CZ064,594326,Lančov,42,70,112,99.12,64.57,175
CZ064,594334,Lechovice,105,162,267,99.63,65.69,408
CZ064,594342,Lesná,39,108,147,100.00,73.13,201
CZ064,594351,Lesonice,67,81,148,100.00,76.68,193
CZ064,594369,Litobratřice,69,171,240,100.00,62.50,384
CZ064,594385,Lubnice,15,25,40,100.00,81.63,49
CZ064,594393,Lukov,66,86,152,98.70,74.04,208
CZ064,594407,Mackovice,72,161,233,100.00,72.59,321
CZ064,594415,Mašovice,161,144,305,100.00,75.68,403
CZ064,594423,Medlice,43,73,116,100.00,78.38,148
CZ064,594431,Mikulovice,126,245,371,98.93,72.96,514
CZ064,594440,Milíčovice,48,71,119,100.00,71.26,167
CZ064,594458,Miroslav,752,969,1721,99.77,73.40,2350
CZ064,594466,Miroslavské Knínice,106,115,221,100.00,72.94,303
CZ064,594474,Morašice,61,63,124,99.20,67.57,185
CZ064,594482,Moravský Krumlov,1714,1531,3245,99.78,70.83,4593
CZ064,594512,Našiměřice,47,66,113,100.00,68.90,164
CZ064,594521,Němčičky,27,28,55,100.00,79.71,69
CZ064,594555,Olbramkostel,112,186,298,99.67,72.57,412
CZ064,594563,Olbramovice,268,364,632,99.68,70.44,900
CZ064,594571,Oleksovice,142,246,388,99.74,71.38,545
CZ064,594580,Onšov,15,29,44,100.00,77.19,57
CZ064,594598,Oslnovice,12,30,42,97.67,67.19,64
CZ064,594601,Pavlice,150,160,310,100.00,81.15,382
CZ064,594610,Petrovice,90,107,197,99.49,66.67,297
CZ064,594628,Plaveč,129,162,291,99.32,75.91,386
CZ064,594636,Podhradí nad Dyjí,21,18,39,100.00,75.00,52
CZ064,594644,Podmolí,30,58,88,98.88,66.92,133
CZ064,594652,Podmyče,21,39,60,100.00,61.86,97
CZ064,594679,Práče,236,215,451,99.78,71.52,632
CZ064,594687,Pravice,58,115,173,99.43,56.13,310
CZ064,594695,Prokopov,20,26,46,100.00,62.16,74
CZ064,594709,Prosiměřice,193,327,520,99.24,74.43,704
CZ064,594725,Rešice,99,105,204,99.51,74.28,276
CZ064,594733,Rozkoš,41,61,102,98.08,68.87,151
CZ064,594741,Rudlice,24,30,54,100.00,62.07,87
CZ064,594750,Rybníky,129,135,264,99.62,73.41,361
CZ064,594768,Skalice,110,156,266,98.52,68.53,394
CZ064,594776,Slatina,29,119,148,100.00,81.32,182
CZ064,594784,Slup,121,175,296,99.33,74.69,399
CZ064,594792,Stálky,32,28,60,100.00,60.61,99
CZ064,594806,Starý Petřín,41,84,125,100.00,66.84,187
CZ064,594814,Stošíkovice na Louce,52,106,158,99.37,68.24,233
CZ064,594822,Strachotice,149,330,479,99.79,60.99,787
CZ064,594831,Střelice,45,53,98,100.00,70.50,139
CZ064,594849,Suchohrdly u Miroslavi,141,138,279,100.00,70.81,394
CZ064,594865,Šafov,28,40,68,100.00,59.13,115
CZ064,594873,Šanov,288,490,778,99.36,62.14,1260
CZ064,594881,Šatov,256,366,622,99.36,69.79,897
CZ064,594890,Štítary,90,245,335,100.00,70.38,476
CZ064,594911,Šumná,142,193,335,99.70,70.00,480
CZ064,594920,Tasovice,381,402,783,99.49,70.27,1120
CZ064,594938,Tavíkovice,106,187,293,100.00,60.04,488
CZ064,594946,Těšetice,161,191,352,99.72,74.32,475
CZ064,594954,Trnové Pole,41,36,77,100.00,78.57,98
CZ064,594971,Trstěnice,117,179,296,99.33,69.30,430
CZ064,594989,Tulešice,55,68,123,100.00,74.25,167
CZ064,594997,Tvořihráz,92,152,244,100.00,74.16,329
CZ064,595004,Uherčice,73,127,200,100.00,64.72,309
CZ064,595012,Újezd,19,28,47,100.00,69.12,68
CZ064,595021,Únanov,361,366,727,99.05,74.52,985
CZ064,595039,Valtrovice,63,133,196,98.99,63.06,314
CZ064,595047,Vedrovice,289,236,525,99.81,74.29,708
CZ064,595055,Vémyslice,146,243,389,99.74,66.44,587
CZ064,595063,Vevčice,23,28,51,100.00,82.26,62
CZ064,595071,Višňové,320,330,650,99.85,73.89,881
CZ064,595080,Vítonice,60,98,158,100.00,74.88,211
CZ064,595098,Vranov nad Dyjí,211,234,445,99.55,69.73,641
CZ064,595101,Vranovská Ves,72,102,174,99.43,77.09,227
CZ064,595110,Vratěnín,51,113,164,100.00,70.69,232
CZ064,595128,Vrbovec,245,356,601,99.17,68.01,891
CZ064,595136,Výrovice,40,65,105,100.00,72.92,144
CZ064,595144,Vysočany,25,26,51,98.08,69.33,75
CZ064,595152,Zálesí,23,67,90,100.00,65.22,138
CZ064,595161,Zblovice,25,7,32,100.00,82.05,39
CZ064,595179,Želetice,53,119,172,100.00,71.07,242
CZ064,595187,Žerotice,74,122,196,99.49,69.72,284
CZ064,595195,Žerůtky,81,77,158,98.75,75.94,212
CZ063,530646,Hurtova Lhota,68,65,133,100.00,65.20,204
CZ063,530654,Vysoká,99,54,153,98.71,81.15,191
CZ063,530662,Ždírec,59,30,89,95.70,74.02,127
CZ063,546194,Bačkov,31,39,70,100.00,69.31,101
CZ063,546216,Jitkov,86,54,140,100.00,72.92,192
CZ063,548189,Kouty,64,46,110,99.10,68.94,161
CZ063,548197,Nejepín,22,24,46,100.00,70.77,65
CZ063,548243,Horní Paseka,22,19,41,100.00,67.21,61
CZ063,548251,Podmoky,27,49,76,100.00,73.08,104
CZ063,548260,Bartoušov,61,61,122,100.00,79.22,154
CZ063,548278,Břevnice,56,40,96,100.00,79.34,121
CZ063,548286,Knyk,149,108,257,99.61,77.48,333
CZ063,548308,Kyjov,52,43,95,98.96,78.05,123
CZ063,548316,Michalovice,78,35,113,100.00,79.02,143
CZ063,548324,Skorkov,21,38,59,100.00,83.10,71
CZ063,548341,Slavníč,26,18,44,100.00,73.33,60
CZ063,548359,Ostrov,47,47,94,100.00,78.33,120
CZ063,548375,Čečkovice,35,27,62,100.00,86.11,72
CZ063,548413,Jilem,51,42,93,98.94,88.68,106
CZ063,548421,Sedletín,109,91,200,100.00,80.97,247
CZ063,548430,Bezděkov,64,77,141,99.30,73.58,193
CZ063,548448,Dolní Sokolovec,27,21,48,100.00,70.59,68
CZ063,548481,Lány,25,15,40,100.00,86.96,46
CZ063,548499,Sloupno,15,11,26,100.00,78.79,33
CZ063,548529,Kochánov,64,34,98,98.00,74.07,135
CZ063,548537,Úhořilka,26,7,33,100.00,89.19,37
CZ063,548553,Slavětín,32,28,60,96.77,80.52,77
CZ063,548570,Kunemil,29,35,64,100.00,72.73,88
CZ063,548588,Okrouhlička,96,58,154,100.00,80.63,191
CZ063,548596,Heřmanice,17,17,34,100.00,72.34,47
CZ063,548618,Kraborovice,30,27,57,100.00,66.28,86
CZ063,548626,Zvěstovice,17,18,35,100.00,64.81,54
CZ063,548634,Podmoklany,33,48,81,100.00,77.14,105
CZ063,555266,Nová Ves u Světlé,207,113,320,99.38,80.70,399
CZ063,568414,Havlíčkův Brod,7668,5196,12864,99.45,72.52,17846
CZ063,568457,Bojiště,103,75,178,100.00,79.11,225
CZ063,568465,Borek,43,37,80,98.77,79.41,102
CZ063,568490,Čachotín,53,44,97,100.00,71.32,136
CZ063,568503,Česká Bělá,379,240,619,99.04,77.16,810
CZ063,568520,Číhošť,90,126,216,100.00,78.83,274
CZ063,568538,Dlouhá Ves,109,139,248,99.60,75.45,330
CZ063,568597,Dolní Krupá,144,84,228,99.56,66.18,346
CZ063,568601,Dolní Město,287,289,576,99.65,76.25,758
CZ063,568619,Druhanov,62,47,109,100.00,85.16,128
CZ063,568635,Golčův Jeníkov,744,708,1452,99.73,70.41,2068
CZ063,568651,Habry,322,425,747,99.60,72.60,1033
CZ063,568660,Havlíčkova Borová,364,221,585,98.82,77.08,768
CZ063,568678,Herálec,332,341,673,98.97,74.56,912
CZ063,568694,Hněvkovice,196,190,386,100.00,77.98,495
CZ063,568708,Horní Krupá,250,82,332,99.40,79.71,419
CZ063,568724,Hradec,84,60,144,99.31,69.71,208
CZ063,568759,Chotěboř,2934,2327,5261,99.41,73.64,7186
CZ063,568767,Chrtníč,33,34,67,98.53,67.33,101
CZ063,568783,Jedlá,23,23,46,100.00,64.79,71
CZ063,568805,Jeřišno,67,101,168,99.41,76.82,220
CZ063,568821,Kámen,119,116,235,99.58,72.39,326
CZ063,568848,Kamenná Lhota,77,87,164,100.00,75.23,218
CZ063,568856,Klokočov,26,52,78,100.00,84.78,92
CZ063,568881,Kojetín,68,42,110,99.10,79.29,140
CZ063,568899,Kozlov,56,78,134,100.00,76.57,175
CZ063,568902,Kožlí,244,235,479,100.00,72.58,660
CZ063,568929,Krásná Hora,143,137,280,100.00,69.48,403
CZ063,568937,Krátká Ves,35,50,85,100.00,79.44,107
CZ063,568945,Krucemburk,596,369,965,99.69,75.94,1276
CZ063,568953,Květinov,69,54,123,99.19,76.07,163
CZ063,568970,Kynice,27,23,50,98.04,66.23,77
CZ063,568988,Ledeč nad Sázavou,1457,1314,2771,99.64,71.71,3878
CZ063,568996,Leškovice,42,14,56,100.00,82.35,68
CZ063,569011,Leština u Světlé,130,190,320,99.69,69.93,459
CZ063,569020,Libice nad Doubravou,266,286,552,99.82,80.49,687
CZ063,569038,Lípa,411,273,684,99.56,77.28,889
CZ063,569046,Lipnice nad Sázavou,205,183,388,99.23,76.52,511
CZ063,569062,Lučice,245,148,393,99.75,77.87,506
CZ063,569071,Malčín,66,65,131,99.24,76.74,172
CZ063,569089,Maleč,186,208,394,99.75,76.40,517
CZ063,569127,Modlíkov,65,37,102,99.03,78.03,132
CZ063,569151,Nová Ves u Leštiny,23,45,68,100.00,69.39,98
CZ063,569160,Nová Ves u Chotěboře,155,198,353,98.88,82.07,435
CZ063,569186,Okrouhlice,496,328,824,99.04,77.54,1073
CZ063,569208,Olešenka,83,22,105,100.00,73.94,142
CZ063,569216,Olešná,120,91,211,99.53,75.99,279
CZ063,569224,Oudoleň,143,91,234,100.00,80.69,290
CZ063,569232,Ovesná Lhota,32,62,94,98.95,71.97,132
CZ063,569241,Pavlov,38,43,81,100.00,83.51,97
CZ063,569291,Pohled,221,188,409,99.27,72.03,572
CZ063,569313,Prosíčka,38,32,70,100.00,64.22,109
CZ063,569321,Přibyslav,1471,756,2227,99.24,74.21,3024
CZ063,569348,Příseka,131,101,232,100.00,69.25,335
CZ063,569364,Radostín,55,35,90,98.90,77.12,118
CZ063,569399,Rozsochatec,204,117,321,100.00,78.10,411
CZ063,569402,Rušinov,33,67,100,99.01,75.94,133
CZ063,569411,Rybníček,25,24,49,100.00,77.78,63
CZ063,569429,Sázavka,142,66,208,100.00,83.20,250
CZ063,569461,Skryje,39,68,107,99.07,73.47,147
CZ063,569470,Skuhrov,105,78,183,100.00,75.93,241
CZ063,569488,Slavíkov,121,76,197,99.49,78.88,251
CZ063,569518,Sobíňov,219,214,433,99.31,75.83,575
CZ063,569534,Stříbrné Hory,77,71,148,99.33,76.41,195
CZ063,569569,Světlá nad Sázavou,1993,2111,4104,99.61,72.54,5684
CZ063,569585,Šlapanov,223,179,402,99.50,67.22,601
CZ063,569593,Štoky,611,522,1133,99.47,78.55,1450
CZ063,569615,Tis,95,111,206,100.00,72.54,284
CZ063,569623,Trpišovice,47,43,90,100.00,63.83,141
CZ063,569640,Uhelná Příbram,136,171,307,99.03,78.68,394
CZ063,569658,Úsobí,208,200,408,98.79,71.83,575
CZ063,569674,Vepříkov,114,91,205,98.09,75.81,277
CZ063,569682,Veselý Žďár,222,128,350,99.43,77.70,453
CZ063,569691,Věž,253,252,505,99.21,77.36,658
CZ063,569704,Věžnice,160,83,243,99.18,72.49,338
CZ063,569712,Vilémov,306,288,594,100.00,73.33,810
CZ063,569721,Vilémovice,90,75,165,99.40,85.13,195
CZ063,569739,Vlkanov,20,11,31,100.00,75.61,41
CZ063,569780,Ždírec nad Doubravou,1034,816,1850,99.78,77.03,2407
CZ063,569801,Žižkovo Pole,169,88,257,99.61,81.13,318
CZ063,573558,Boňkov,24,24,48,100.00,73.85,65
CZ063,573566,Bělá,52,99,151,98.69,79.38,194
CZ063,573574,Chřenovice,29,61,90,100.00,69.23,130
CZ063,573582,Víska,70,35,105,99.06,77.37,137
CZ063,573591,Pohleď,25,24,49,100.00,81.67,60
CZ063,573604,Služátky,57,46,103,100.00,78.63,131
CZ063,506729,Dvorce,59,63,122,100.00,72.19,169
CZ063,547255,Švábov,28,26,54,100.00,79.41,68
CZ063,550281,Hybrálec,196,109,305,100.00,76.44,399
CZ063,550299,Smrčná,136,116,252,100.00,71.19,354
CZ063,586846,Jihlava,16300,10282,26582,99.57,70.03,38140
CZ063,586854,Arnolec,46,53,99,97.06,75.56,135
CZ063,586862,Batelov,687,708,1395,99.50,75.13,1870
CZ063,586889,Bílý Kámen,126,54,180,100.00,82.95,217
CZ063,586897,Bítovčice,120,114,234,99.15,72.39,326
CZ063,586901,Bohuslavice,60,21,81,100.00,76.42,106
CZ063,586927,Boršov,63,42,105,100.00,75.54,139
CZ063,586943,Brtnice,1257,961,2218,99.64,75.46,2950
CZ063,586951,Brzkov,126,65,191,100.00,78.60,243
CZ063,586978,Cejle,177,134,311,99.36,76.34,410
CZ063,586986,Cerekvička-Rosice,72,58,130,100.00,81.25,160
CZ063,587001,Černíč,40,26,66,98.51,65.69,102
CZ063,587010,Dlouhá Brtnice,122,90,212,99.07,74.05,289
CZ063,587028,Dobronín,514,483,997,99.70,68.03,1470
CZ063,587036,Dobroutov,94,66,160,100.00,69.26,231
CZ063,587044,Dolní Cerekev,374,343,717,99.72,73.90,973
CZ063,587061,Dolní Vilímeč,35,27,62,100.00,80.52,77
CZ063,587079,Doupě,32,30,62,98.41,79.75,79
CZ063,587087,Dudín,50,66,116,100.00,75.82,153
CZ063,587095,Dušejov,174,115,289,100.00,77.69,372
CZ063,587109,Dyjice,56,30,86,100.00,74.78,115
CZ063,587117,Čížov,111,79,190,99.48,77.02,248
CZ063,587125,Hladov,66,43,109,100.00,75.69,144
CZ063,587141,Hodice,246,193,439,99.55,74.49,592
CZ063,587150,Hojkov,67,39,106,100.00,83.46,127
CZ063,587168,Horní Dubenky,130,164,294,98.66,64.36,463
CZ063,587176,Rančířov,205,78,283,99.30,81.43,350
CZ063,587184,Borovná,25,33,58,98.31,80.82,73
CZ063,587192,Hostětice,47,27,74,100.00,66.67,111
CZ063,587206,Horní Myslová,42,7,49,100.00,80.33,61
CZ063,587214,Olší,33,9,42,97.67,81.13,53
CZ063,587222,Hubenov,63,35,98,100.00,88.29,111
CZ063,587231,Zadní Vydří,8,13,21,100.00,53.85,39
CZ063,587249,Jamné,172,107,279,99.64,69.63,405
CZ063,587265,Jersín,49,57,106,100.00,70.67,150
CZ063,587273,Jezdovice,61,73,134,99.26,68.53,197
CZ063,587281,Ježená,31,38,69,100.00,72.63,95
CZ063,587290,Jihlávka,43,62,105,100.00,64.81,162
CZ063,587303,Jindřichovice,34,29,63,100.00,78.75,80
CZ063,587320,Kalhov,30,43,73,100.00,70.87,103
CZ063,587338,Kaliště,57,43,100,99.01,72.66,139
CZ063,587346,Kamenice,664,478,1142,99.74,75.83,1510
CZ063,587362,Kamenná,56,68,124,100.00,83.78,148
CZ063,587371,Klatovec,20,29,49,100.00,81.67,60
CZ063,587389,Knínice,88,33,121,100.00,76.10,159
CZ063,587401,Kostelec,184,260,444,99.55,69.47,642
CZ063,587419,Kostelní Myslová,19,22,41,100.00,70.69,58
CZ063,587427,Kozlov,186,100,286,98.96,77.69,372
CZ063,587435,Krahulčí,179,174,353,100.00,72.19,489
CZ063,587443,Krasonice,87,50,137,100.00,80.59,170
CZ063,587451,Lhotka,43,32,75,98.68,89.41,85
CZ063,587478,Luka nad Jihlavou,1166,607,1773,99.49,75.77,2352
CZ063,587486,Malý Beranov,237,112,349,99.43,71.49,491
CZ063,587494,Markvartice,60,68,128,99.22,81.65,158
CZ063,587508,Měšín,76,83,159,98.76,76.30,211
CZ063,587524,Milíčov,46,47,93,100.00,76.86,121
CZ063,587532,Mirošov,46,42,88,100.00,66.17,133
CZ063,587541,Mrákotín,265,241,506,99.61,72.88,697
CZ063,587559,Mysletice,56,24,80,100.00,75.47,106
CZ063,587567,Mysliboř,90,28,118,99.16,78.29,152
CZ063,587575,Nadějov,70,40,110,97.35,77.40,146
CZ063,587583,Nevcehle,81,45,126,98.44,68.45,187
CZ063,587591,Nová Říše,324,169,493,99.80,75.30,656
CZ063,587613,Olšany,38,9,47,100.00,78.33,60
CZ063,587621,Opatov,89,33,122,97.60,75.30,166
CZ063,587630,Ořechov,27,17,44,95.65,80.70,57
CZ063,587648,Otín,32,30,62,100.00,80.52,77
CZ063,587656,Panenská Rozsíčka,75,55,130,99.24,82.39,159
CZ063,587672,Panské Dubenky,30,46,76,100.00,76.00,100
CZ063,587681,Pavlov,132,110,242,100.00,70.97,341
CZ063,587702,Plandry,82,40,122,100.00,77.71,157
CZ063,587711,Polná,1711,1218,2929,99.46,72.69,4053
CZ063,587745,Puklice,259,219,478,99.38,72.66,662
CZ063,587761,Radkov,85,60,145,100.00,77.13,188
CZ063,587788,Rantířov,183,94,277,100.00,81.71,339
CZ063,587796,Rohozná,119,146,265,99.62,81.35,327
CZ063,587800,Rozseč,53,44,97,100.00,70.29,138
CZ063,587818,Růžená,118,85,203,99.51,76.69,266
CZ063,587826,Rybné,45,31,76,97.44,84.04,94
CZ063,587834,Řásná,85,53,138,97.87,70.15,201
CZ063,587851,Řídelov,38,20,58,100.00,80.56,72
CZ063,587877,Sedlatice,27,10,37,100.00,77.08,48
CZ063,587885,Sedlejov,125,62,187,99.47,80.69,233
CZ063,587915,Stáj,66,41,107,100.00,73.79,145
CZ063,587923,Stará Říše,243,138,381,100.00,78.12,489
CZ063,587931,Stonařov,332,278,610,99.67,72.34,846
CZ063,587940,Strachoňovice,28,18,46,95.83,65.75,73
CZ063,587958,Střítež,165,111,276,99.64,79.14,350
CZ063,587982,Suchá,74,86,160,100.00,73.73,217
CZ063,587991,Svojkovice,15,19,34,100.00,70.83,48
CZ063,588008,Šimanov,69,48,117,97.50,67.80,177
CZ063,588024,Telč,1957,1061,3018,99.67,72.15,4198
CZ063,588032,Třešť,1863,1287,3150,99.56,71.80,4408
CZ063,588041,Třeštice,66,37,103,100.00,88.79,116
CZ063,588067,Urbanov,74,18,92,100.00,92.00,100
CZ063,588075,Ústí,60,75,135,99.26,75.56,180
CZ063,588083,Vanov,31,23,54,100.00,77.14,70
CZ063,588091,Vanůvek,9,11,20,100.00,76.92,26
CZ063,588105,Vápovice,18,11,29,96.67,100.00,30
CZ063,588113,Velký Beranov,469,297,766,99.48,74.06,1041
CZ063,588121,Větrný Jeníkov,191,180,371,100.00,75.10,494
CZ063,588130,Věžnice,53,42,95,100.00,78.51,121
CZ063,588148,Věžnička,55,22,77,98.72,79.59,98
CZ063,588156,Vílanec,105,94,199,99.50,76.63,261
CZ063,588164,Volevčice,24,16,40,100.00,81.63,49
CZ063,588172,Vyskytná nad Jihlavou,325,212,537,99.44,73.77,732
CZ063,588181,Vysoké Studnice,160,93,253,100.00,77.61,326
CZ063,588199,Vystrčenovice,46,23,69,100.00,73.40,94
CZ063,588202,Záborná,81,67,148,98.67,76.14,197
CZ063,588211,Zbilidy,62,72,134,100.00,82.21,163
CZ063,588229,Zbinohy,19,45,64,98.46,82.28,79
CZ063,588245,Zdeňkov,31,15,46,100.00,92.00,50
CZ063,588253,Zhoř,193,87,280,100.00,76.71,365
CZ063,588261,Zvolenovice,40,8,48,97.96,77.78,63
CZ063,588270,Žatec,56,17,73,100.00,73.00,100
CZ063,588288,Ždírec,186,94,280,100.00,76.92,364
CZ063,590371,Brtnička,27,34,61,100.00,73.49,83
CZ063,590681,Hrutov,36,24,60,100.00,75.00,80
CZ063,590843,Kněžice,443,345,788,99.37,71.57,1108
CZ063,509388,Arneštovice,22,37,59,100.00,92.19,64
CZ063,509418,Bořetín,53,29,82,100.00,86.32,95
CZ063,529826,Čelistná,39,16,55,100.00,75.34,73
CZ063,529834,Mezná,66,21,87,100.00,73.11,119
CZ063,529869,Důl,13,29,42,95.45,77.19,57
CZ063,537594,Střítež,28,33,61,100.00,69.32,88
CZ063,537608,Ústrašín,91,67,158,98.75,80.40,199
CZ063,537691,Ondřejov,76,31,107,99.07,80.00,135
CZ063,537730,Útěchovičky,28,17,45,100.00,81.82,55
CZ063,537829,Proseč,15,40,55,100.00,85.94,64
CZ063,547492,Pelhřimov,5598,3394,8992,99.51,73.37,12322
CZ063,547549,Bohdalín,56,61,117,100.00,75.48,155
CZ063,547581,Božejov,201,155,356,100.00,71.92,495
CZ063,547603,Bratřice,20,64,84,100.00,68.29,123
CZ063,547638,Budíkov,90,112,202,98.54,83.67,245
CZ063,547662,Cetoraz,111,91,202,100.00,72.92,277
CZ063,547689,Čáslavsko,33,37,70,100.00,70.71,99
CZ063,547719,Častrov,208,131,339,99.41,71.04,480
CZ063,547735,Čejov,205,162,367,99.46,81.28,454
CZ063,547760,Černovice,546,373,919,99.89,64.07,1436
CZ063,547778,Červená Řečice,371,244,615,99.84,74.04,832
CZ063,547883,Hojanovice,45,26,71,100.00,88.75,80
CZ063,547913,Horní Cerekev,648,406,1054,99.15,72.96,1457
CZ063,547930,Horní Ves,108,88,196,99.49,75.19,262
CZ063,547948,Hořepník,176,196,372,100.00,75.46,493
CZ063,547956,Hořice,74,57,131,100.00,81.37,161
CZ063,547999,Humpolec,3370,2747,6117,99.58,72.94,8422
CZ063,548073,Ježov,37,14,51,100.00,89.47,57
CZ063,548081,Jiřice,293,271,564,99.47,78.10,726
CZ063,548090,Kaliště,109,133,242,99.59,79.41,306
CZ063,548103,Kámen,111,48,159,100.00,72.27,220
CZ063,548111,Kamenice nad Lipou,1201,800,2001,99.35,69.38,2907
CZ063,548120,Kejžlice,127,144,271,99.63,81.19,335
CZ063,548146,Koberovice,49,60,109,100.00,80.74,135
CZ063,548162,Komorovice,72,48,120,100.00,80.54,149
CZ063,548171,Košetice,188,207,395,99.50,72.58,547
CZ063,548201,Křeč,52,88,140,100.00,75.27,186
CZ063,548219,Křelovice,114,98,212,99.53,76.34,279
CZ063,548227,Křešín,63,34,97,100.00,69.78,139
CZ063,548235,Leskovice,42,28,70,100.00,72.16,97
CZ063,548332,Lukavec,319,272,591,99.66,74.87,792
CZ063,548367,Mezilesí,35,36,71,100.00,76.34,93
CZ063,548383,Mladé Bříště,100,73,173,99.43,76.65,227
CZ063,548391,Mnich,141,107,248,99.20,75.08,333
CZ063,548405,Moraveč,80,34,114,100.00,70.37,162
CZ063,548456,Nová Cerekev,374,310,684,100.00,75.83,906
CZ063,548464,Nový Rychnov,335,245,580,99.15,75.68,773
CZ063,548472,Obrataň,267,206,473,99.58,72.41,656
CZ063,548502,Onšov,76,81,157,100.00,77.72,202
CZ063,548511,Pacov,1607,989,2596,99.50,70.86,3682
CZ063,548545,Píšť,17,33,50,100.00,69.44,72
CZ063,548561,Počátky,750,696,1446,99.72,71.83,2020
CZ063,548600,Pošná,83,70,153,98.08,77.61,201
CZ063,548715,Řečice,46,41,87,98.86,72.13,122
CZ063,548731,Salačova Lhota,47,33,80,100.00,72.07,111
CZ063,548740,Samšín,51,34,85,97.70,70.73,123
CZ063,548766,Sedlice,52,51,103,100.00,83.74,123
CZ063,548774,Senožaty,265,195,460,99.35,73.73,628
CZ063,548936,Těmice,128,111,239,100.00,69.48,344
CZ063,548987,Útěchovice,17,26,43,100.00,82.69,52
CZ063,549002,Včelnička,74,70,144,100.00,77.84,185
CZ063,549011,Velká Chyška,82,91,173,99.43,83.25,209
CZ063,549045,Velký Rybník,73,52,125,100.00,80.13,156
CZ063,549053,Veselá,72,59,131,99.24,72.13,183
CZ063,549061,Věžná,50,44,94,98.95,87.16,109
CZ063,549126,Vojslavice,26,34,60,100.00,67.78,90
CZ063,549134,Vyklantice,27,52,79,98.75,62.99,127
CZ063,549142,Vyskytná,251,188,439,99.32,77.41,571
CZ063,549177,Zachotín,111,48,159,99.38,80.81,198
CZ063,549215,Želiv,397,286,683,99.42,74.27,925
CZ063,549231,Žirovnice,819,682,1501,99.47,69.83,2161
CZ063,551546,Dubovice,25,25,50,100.00,81.97,61
CZ063,551589,Horní Rápotice,64,47,111,100.00,81.62,136
CZ063,561096,Hojovice,31,28,59,98.33,84.51,71
CZ063,561100,Lidmaň,88,48,136,99.27,51.31,267
CZ063,561118,Bácovice,22,30,52,100.00,74.29,70
CZ063,561126,Bělá,17,14,31,91.18,70.83,48
CZ063,561142,Černov,35,40,75,100.00,78.13,96
CZ063,561177,Nová Buková,46,39,85,100.00,95.51,89
CZ063,561240,Bořetice,40,18,58,100.00,79.45,73
CZ063,561266,Litohošť,29,7,36,100.00,66.67,54
CZ063,561274,Rovná,29,14,43,100.00,95.56,45
CZ063,561282,Lhota-Vlasenice,44,23,67,100.00,80.72,83
CZ063,561312,Buřenice,66,59,125,99.21,74.56,169
CZ063,561321,Chyšná,20,33,53,100.00,74.65,71
CZ063,561339,Chýstovice,14,18,32,96.97,91.67,36
CZ063,561347,Martinice u Onšova,23,16,39,100.00,81.25,48
CZ063,561355,Těchobuz,30,15,45,100.00,73.77,61
CZ063,561363,Zhořec,22,40,62,100.00,74.70,83
CZ063,561371,Krasíkovice,58,38,96,100.00,87.27,110
CZ063,561436,Polesí,41,27,68,100.00,90.67,75
CZ063,561452,Stojčín,25,35,60,100.00,65.22,92
CZ063,561461,Jankov,23,12,35,100.00,94.59,37
CZ063,561487,Střítež pod Křemešníkem,31,11,42,100.00,76.36,55
CZ063,561754,Eš,20,14,34,91.89,72.55,51
CZ063,561762,Dobrá Voda u Pacova,55,12,67,100.00,83.75,80
CZ063,561771,Vysoká Lhota,9,6,15,100.00,78.95,19
CZ063,561789,Rodinov,82,65,147,100.00,81.22,181
CZ063,561797,Vystrkov,103,79,182,100.00,84.65,215
CZ063,561801,Bystrá,37,43,80,100.00,77.67,103
CZ063,561819,Mysletín,47,18,65,100.00,76.47,85
CZ063,561843,Staré Bříště,22,22,44,97.78,81.82,55
CZ063,561908,Žirov,31,27,58,100.00,87.88,66
CZ063,561916,Pavlov,46,35,81,98.78,84.54,97
CZ063,561924,Dehtáře,41,34,75,100.00,80.65,93
CZ063,561932,Dobrá Voda,80,52,132,100.00,79.04,167
CZ063,561941,Proseč pod Křemešníkem,42,12,54,94.74,81.43,70
CZ063,561967,Olešná,217,165,382,99.74,81.84,468
CZ063,561975,Zajíčkov,87,57,144,100.00,78.26,184
CZ063,562009,Rynárec,246,132,378,99.74,77.03,492
CZ063,562033,Útěchovice pod Stražištěm,24,52,76,100.00,80.85,94
CZ063,562041,Lesná,29,20,49,100.00,90.74,54
CZ063,598666,Zlátenka,21,9,30,100.00,78.95,38
CZ063,598704,Čížkov,42,48,90,100.00,81.08,111
CZ063,598712,Kojčice,132,81,213,100.00,78.02,273
CZ063,598721,Libkova Voda,80,74,154,100.00,77.39,199
CZ063,598755,Putimov,115,67,182,100.00,82.73,220
CZ063,598763,Svépravice,40,28,68,100.00,71.58,95
CZ063,598771,Syrov,16,25,41,97.62,84.00,50
CZ063,599239,Vokov,90,31,121,100.00,82.88,146
CZ063,510556,Láz,84,94,178,100.00,77.06,231
CZ063,510645,Kojatín,39,19,58,100.00,81.69,71
CZ063,510980,Ocmanice,70,113,183,99.46,68.40,269
CZ063,511081,Sedlec,91,71,162,100.00,79.41,204
CZ063,511242,Vícenice u Náměště nad Oslavou,98,150,248,100.00,77.26,321
CZ063,511307,Rácovice,49,31,80,100.00,87.91,91
CZ063,544752,Příštpo,46,87,133,100.00,61.29,217
CZ063,544833,Bačkovice,14,37,51,100.00,68.00,75
CZ063,544876,Lhotice,25,67,92,100.00,75.41,122
CZ063,544957,Lovčovice,19,27,46,100.00,90.20,51
CZ063,545031,Menhartice,42,46,88,100.00,77.88,113
CZ063,545040,Radotice,36,50,86,100.00,83.50,103
CZ063,545180,Slavíkovice,39,73,112,100.00,70.44,159
CZ063,545309,Kožichovice,129,137,266,99.63,76.29,350
CZ063,546933,Okřešice,70,50,120,98.36,79.22,154
CZ063,550302,Kuroslepy,47,63,110,100.00,79.71,138
CZ063,550311,Třesov,31,25,56,100.00,74.67,75
CZ063,550370,Pokojovice,44,42,86,100.00,89.58,96
CZ063,550388,Martínkov,98,56,154,100.00,81.05,190
CZ063,550400,Bohušice,49,38,87,100.00,77.68,112
CZ063,550469,Pálovice,56,37,93,100.00,68.38,136
CZ063,550477,Chotěbudice,34,29,63,100.00,72.41,87
CZ063,550493,Radkovice u Budče,34,46,80,98.77,70.43,115
CZ063,550507,Litohoř,124,153,277,99.28,62.56,446
CZ063,550566,Lukov,127,116,243,99.59,76.25,320
CZ063,550591,Jiratice,26,15,41,95.35,71.67,60
CZ063,550612,Horní Smrčné,28,13,41,100.00,89.13,46
CZ063,550639,Hroznatín,39,27,66,100.00,72.53,91
CZ063,550710,Krahulov,110,66,176,99.44,77.29,229
CZ063,550779,Naloučany,64,41,105,100.00,76.64,137
CZ063,553964,Častohostice,52,53,105,100.00,68.63,153
CZ063,554871,Střítež,162,157,319,100.00,75.41,423
CZ063,573485,Lesůňky,23,38,61,100.00,84.72,72
CZ063,587460,Stropešín,29,36,65,97.01,67.00,100
CZ063,587605,Lomy,29,35,64,98.46,65.66,99
CZ063,587664,Dolní Lažany,37,61,98,100.00,80.99,121
CZ063,587699,Valdíkov,33,37,70,100.00,78.65,89
CZ063,588342,Vícenice,34,81,115,99.14,72.96,159
CZ063,590266,Třebíč,11273,8341,19614,99.46,71.82,27467
CZ063,590274,Babice,79,61,140,99.29,79.66,177
CZ063,590282,Bačice,53,71,124,99.20,74.40,168
CZ063,590304,Benetice,65,45,110,98.21,75.17,149
CZ063,590312,Biskupice-Pulkov,65,60,125,100.00,57.08,219
CZ063,590321,Blatnice,82,148,230,100.00,76.16,302
CZ063,590347,Bochovice,69,50,119,100.00,88.15,135
CZ063,590363,Bransouze,75,71,146,97.33,77.72,193
CZ063,590380,Březník,208,197,405,99.75,73.02,556
CZ063,590401,Budišov,379,321,700,99.86,74.50,941
CZ063,590410,Budkov,120,88,208,100.00,74.82,278
CZ063,590428,Cidlina,40,34,74,100.00,93.67,79
CZ063,590436,Čáslavice,153,169,322,99.08,74.54,436
CZ063,590444,Čechočovice,94,107,201,100.00,77.31,260
CZ063,590452,Čechtín,102,96,198,99.50,80.89,246
CZ063,590461,Červená Lhota,88,33,121,100.00,77.56,156
CZ063,590479,Číhalín,97,53,150,100.00,85.71,175
CZ063,590487,Číchov,62,77,139,99.29,75.27,186
CZ063,590495,Čikov,71,52,123,100.00,72.78,169
CZ063,590509,Číměř,83,55,138,100.00,77.97,177
CZ063,590517,Dalešice,176,155,331,99.70,67.34,493
CZ063,590525,Dědice,37,42,79,100.00,77.45,102
CZ063,590533,Dešov,136,96,232,100.00,67.64,343
CZ063,590550,Dolní Vilémovice,98,147,245,100.00,70.81,346
CZ063,590568,Domamil,106,95,201,99.50,77.39,261
CZ063,590576,Dukovany,274,236,510,100.00,74.89,681
CZ063,590584,Hartvíkovice,142,181,323,100.00,72.26,447
CZ063,590592,Heraltice,114,115,229,99.57,78.50,293
CZ063,590614,Hluboké,73,43,116,100.00,67.44,172
CZ063,590622,Hodov,98,93,191,98.96,77.20,250
CZ063,590631,Horní Heřmanice,34,56,90,100.00,84.91,106
CZ063,590649,Horní Újezd,107,55,162,98.18,77.46,213
CZ063,590657,Horní Vilémovice,25,18,43,100.00,72.88,59
CZ063,590665,Hornice,33,23,56,100.00,91.80,61
CZ063,590673,Hrotovice,529,448,977,99.19,69.61,1415
CZ063,590690,Hvězdoňovice,23,44,67,100.00,81.71,82
CZ063,590703,Chlístov,105,81,186,100.00,78.48,237
CZ063,590711,Chlum,49,40,89,100.00,80.91,110
CZ063,590746,Jakubov u Moravských Budějovic,210,179,389,99.74,78.31,498
CZ063,590754,Jaroměřice nad Rokytnou,1042,1244,2286,99.74,71.40,3210
CZ063,590762,Jasenice,60,56,116,100.00,81.12,143
CZ063,590789,Jemnice,1224,1039,2263,99.69,71.79,3162
CZ063,590797,Jinošov,79,77,156,99.36,75.48,208
CZ063,590801,Kamenná,81,55,136,100.00,75.14,181
CZ063,590819,Kdousov,37,30,67,100.00,69.79,96
CZ063,590827,Kladeruby nad Oslavou,41,75,116,100.00,74.84,155
CZ063,590835,Klučov,61,61,122,99.19,84.83,145
CZ063,590851,Kojatice,56,81,137,98.56,65.88,211
CZ063,590860,Kojetice,146,136,282,99.65,76.28,371
CZ063,590878,Komárovice,33,33,66,98.51,70.53,95
CZ063,590886,Koněšín,140,163,303,100.00,74.63,406
CZ063,590894,Kostníky,59,59,118,99.16,77.27,154
CZ063,590908,Kouty,153,87,240,100.00,79.47,302
CZ063,590916,Kozlany,65,29,94,100.00,78.33,120
CZ063,590941,Kralice nad Oslavou,297,264,561,99.29,73.95,764
CZ063,590959,Kramolín,47,37,84,100.00,74.34,113
CZ063,590967,Krhov,45,62,107,99.07,75.00,144
CZ063,590975,Krokočín,65,73,138,100.00,81.18,170
CZ063,590983,Lesná,28,31,59,98.33,81.08,74
CZ063,590991,Lesní Jakubov,107,363,470,99.37,83.72,565
CZ063,591009,Lesonice,129,134,263,98.87,68.56,388
CZ063,591025,Lhánice,55,41,96,100.00,71.64,134
CZ063,591041,Lipník,133,113,246,99.19,76.31,325
CZ063,591068,Litovany,38,37,75,98.68,70.37,108
CZ063,591092,Loukovice,38,35,73,98.65,79.57,93
CZ063,591114,Markvartice,92,72,164,100.00,77.73,211
CZ063,591122,Mastník,78,50,128,100.00,72.32,177
CZ063,591149,Meziříčko,25,27,52,100.00,71.23,73
CZ063,591157,Mikulovice,68,70,138,98.57,79.55,176
CZ063,591165,Mladoňovice,129,84,213,100.00,70.86,302
CZ063,591173,Mohelno,413,377,790,99.37,72.80,1092
CZ063,591181,Moravské Budějovice,2340,1843,4183,99.55,72.28,5815
CZ063,591190,Myslibořice,176,198,374,99.47,67.26,559
CZ063,591211,Náměšť nad Oslavou,1441,1290,2731,99.27,69.93,3934
CZ063,591220,Nárameč,118,91,209,100.00,73.59,284
CZ063,591238,Nimpšov,15,25,40,97.56,75.93,54
CZ063,591246,Nová Ves,98,56,154,98.72,85.25,183
CZ063,591254,Nové Syrovice,206,257,463,100.00,65.67,705
CZ063,591262,Nový Telečkov,45,32,77,100.00,84.62,91
CZ063,591289,Odunec,44,20,64,100.00,82.05,78
CZ063,591297,Okarec,35,30,65,100.00,65.66,99
CZ063,591301,Okříšky,651,510,1161,99.57,71.05,1641
CZ063,591319,Opatov,232,242,474,100.00,76.21,622
CZ063,591327,Oponešice,58,48,106,100.00,74.65,142
CZ063,591335,Ostašov,44,48,92,100.00,85.19,108
CZ063,591360,Petrovice,123,126,249,99.60,73.75,339
CZ063,591378,Petrůvky,42,36,78,98.73,83.16,95
CZ063,591394,Police,91,94,185,99.46,68.63,271
CZ063,591408,Popůvky,20,23,43,100.00,71.67,60
CZ063,591416,Pozďatín,47,52,99,100.00,73.88,134
CZ063,591424,Přeckov,44,13,57,100.00,98.28,58
CZ063,591432,Předín,217,178,395,99.75,70.21,564
CZ063,591441,Přešovice,28,56,84,100.00,77.06,109
CZ063,591459,Přibyslavice,249,239,488,99.59,77.29,634
CZ063,591491,Pucov,25,62,87,100.00,69.60,125
CZ063,591505,Pyšel,136,155,291,99.32,78.55,373
CZ063,591521,Račice,26,39,65,100.00,85.53,76
CZ063,591548,Radkovice u Hrotovic,100,115,215,100.00,81.44,264
CZ063,591556,Radonín,25,25,50,100.00,71.43,70
CZ063,591564,Radošov,59,56,115,98.29,79.59,147
CZ063,591581,Rapotice,180,116,296,100.00,70.64,419
CZ063,591602,Rohy,41,30,71,100.00,72.45,98
CZ063,591611,Rokytnice nad Rokytnou,326,241,567,99.65,83.07,685
CZ063,591629,Rouchovany,363,325,688,99.14,74.70,929
CZ063,591637,Rudíkov,253,177,430,99.54,79.56,543
CZ063,591645,Římov,118,122,240,100.00,69.16,347
CZ063,591688,Slavětice,53,82,135,98.54,74.46,184
CZ063,591700,Slavičky,98,65,163,100.00,75.12,217
CZ063,591726,Smrk,70,88,158,97.53,73.64,220
CZ063,591742,Stařeč,565,440,1005,99.90,76.65,1315
CZ063,591769,Studenec,179,158,337,99.70,73.96,457
CZ063,591777,Studnice,44,21,65,100.00,60.19,108
CZ063,591785,Sudice,101,93,194,98.98,70.50,278
CZ063,591793,Svatoslav,96,61,157,100.00,79.29,198
CZ063,591807,Šebkovice,128,150,278,100.00,72.40,384
CZ063,591815,Štěměchy,98,79,177,100.00,71.66,247
CZ063,591823,Štěpkov,30,41,71,100.00,88.75,80
CZ063,591840,Trnava,229,183,412,100.00,75.05,549
CZ063,591858,Třebelovice,155,109,264,99.62,76.81,345
CZ063,591866,Třebenice,124,132,256,100.00,71.31,359
CZ063,591874,Valeč,262,211,473,99.58,77.11,616
CZ063,591904,Vladislav,346,358,704,99.72,75.27,938
CZ063,591912,Vlčatín,44,37,81,98.78,75.93,108
CZ063,591939,Výčapy,309,191,500,99.80,75.68,662
CZ063,591947,Zahrádka,36,64,100,100.00,85.47,117
CZ063,591955,Zárubice,45,43,88,98.88,86.41,103
CZ063,591963,Zašovice,39,42,81,100.00,73.64,110
CZ063,591980,Zvěrkovice,47,80,127,100.00,74.27,171
CZ063,591998,Želetava,482,338,820,99.15,70.68,1170
CZ063,511412,Oslavička,39,33,72,100.00,72.73,99
CZ063,549835,Milasín,18,22,40,97.56,95.35,43
CZ063,549886,Střítež,38,39,77,100.00,80.21,96
CZ063,549916,Pikárec,131,62,193,99.48,76.08,255
CZ063,549924,Radkov,40,60,100,99.01,75.37,134
CZ063,549941,Rosička,20,10,30,96.77,86.11,36
CZ063,549959,Ubušínek,53,10,63,100.00,81.82,77
CZ063,587516,Meziříčko,70,25,95,100.00,72.73,132
CZ063,587737,Rodkov,47,23,70,100.00,85.37,82
CZ063,587753,Tři Studně,87,33,120,98.36,87.77,139
CZ063,587770,Milešín,23,29,52,100.00,76.47,68
CZ063,587842,Křídla,144,79,223,99.11,77.66,291
CZ063,587869,Vlachovice,81,38,119,100.00,86.86,137
CZ063,587893,Velké Tresné,35,27,62,100.00,72.09,86
CZ063,587974,Nové Dvory,140,71,211,99.06,81.30,262
CZ063,588016,Cikháj,26,28,54,98.18,63.95,86
CZ063,588059,Račín,52,30,82,100.00,76.64,107
CZ063,588237,Sazomín,88,69,157,100.00,83.96,187
CZ063,588334,Vysoké,79,35,114,97.44,81.25,144
CZ063,591831,Tasov,222,141,363,98.37,72.78,507
CZ063,595209,Žďár nad Sázavou,7242,4391,11633,99.52,71.67,16316
CZ063,595217,Baliny,51,28,79,98.75,74.07,108
CZ063,595241,Blažkov,84,71,155,100.00,70.14,221
CZ063,595250,Blízkov,137,77,214,100.00,78.97,271
CZ063,595268,Bobrová,298,213,511,99.61,73.29,700
CZ063,595276,Bobrůvka,87,64,151,99.34,75.25,202
CZ063,595284,Bohdalec,117,70,187,100.00,80.60,232
CZ063,595292,Bohdalov,363,299,662,99.40,74.92,889
CZ063,595306,Bohuňov,89,75,164,97.04,78.97,214
CZ063,595322,Borovnice,61,47,108,100.00,70.13,154
CZ063,595349,Březejc,56,45,101,100.00,78.91,128
CZ063,595357,Březí,58,61,119,99.17,78.95,152
CZ063,595365,Březí nad Oslavou,106,72,178,97.80,80.18,227
CZ063,595381,Březské,61,44,105,100.00,75.18,141
CZ063,595390,Budeč,93,34,127,97.69,86.67,150
CZ063,595403,Bukov,56,62,118,100.00,77.63,152
CZ063,595411,Bystřice nad Pernštejnem,2285,2157,4442,99.35,69.73,6413
CZ063,595420,Býšovec,68,45,113,98.26,79.31,145
CZ063,595438,Černá,89,88,177,100.00,74.68,237
CZ063,595454,Dalečín,258,150,408,99.76,74.64,548
CZ063,595462,Daňkovice,59,39,98,98.00,78.74,127
CZ063,595471,Dlouhé,118,54,172,100.00,84.73,203
CZ063,595489,Dobrá Voda,125,83,208,100.00,75.09,277
CZ063,595501,Dolní Heřmanice,193,124,317,99.69,75.71,420
CZ063,595519,Dolní Libochová,47,46,93,100.00,76.23,122
CZ063,595535,Dolní Rožínka,160,175,335,100.00,68.93,486
CZ063,595578,Fryšava pod Žákovou horou,157,90,247,99.60,78.73,315
CZ063,595586,Hamry nad Sázavou,653,317,970,99.18,79.90,1224
CZ063,595594,Herálec,406,415,821,99.88,76.54,1074
CZ063,595608,Heřmanov,73,60,133,98.52,82.32,164
CZ063,595624,Hodíškov,58,26,84,100.00,68.29,123
CZ063,595641,Bory,243,197,440,99.10,71.38,622
CZ063,595659,Horní Libochová,41,73,114,100.00,74.51,153
CZ063,595675,Horní Radslavice,43,15,58,100.00,80.56,72
CZ063,595683,Horní Rožínka,30,21,51,100.00,73.91,69
CZ063,595705,Chlum-Korouhvice,19,10,29,96.67,85.71,35
CZ063,595713,Chlumek,52,39,91,100.00,71.65,127
CZ063,595721,Chlumětín,74,68,142,99.30,80.34,178
CZ063,595730,Jabloňov,119,82,201,98.53,76.12,268
CZ063,595748,Javorek,46,29,75,100.00,91.46,82
CZ063,595756,Jámy,225,138,363,99.45,79.05,463
CZ063,595772,Jimramov,407,234,641,99.38,71.04,908
CZ063,595802,Jívoví,106,86,192,98.97,85.84,226
CZ063,595811,Kadolec,21,70,91,100.00,65.94,138
CZ063,595829,Kadov,92,49,141,100.00,81.03,174
CZ063,595845,Karlov,44,26,70,100.00,78.65,89
CZ063,595853,Kněževes,72,38,110,100.00,85.27,129
CZ063,595861,Koroužné,70,70,140,99.29,69.46,203
CZ063,595870,Kotlasy,48,25,73,100.00,77.66,94
CZ063,595888,Kozlov,52,47,99,100.00,63.46,156
CZ063,595896,Krásné,39,35,74,100.00,74.00,100
CZ063,595900,Krásněves,96,70,166,100.00,74.11,224
CZ063,595918,Křižánky,169,103,272,99.27,79.65,344
CZ063,595926,Křižanov,571,413,984,99.09,72.80,1364
CZ063,595951,Křoví,183,186,369,99.73,75.66,489
CZ063,595969,Kuklík,72,66,138,100.00,85.71,161
CZ063,595977,Kundratice,58,56,114,99.13,77.70,148
CZ063,596001,Kyjov,11,16,27,100.00,84.38,32
CZ063,596019,Lavičky,232,109,341,99.71,74.67,458
CZ063,596035,Lhotka,69,60,129,99.23,77.84,167
CZ063,596051,Lísek,141,83,224,100.00,76.45,293
CZ063,596060,Líšná,21,17,38,100.00,77.55,49
CZ063,596086,Malá Losenice,113,48,161,98.77,76.17,214
CZ063,596094,Martinice,177,117,294,99.32,83.15,356
CZ063,596108,Matějov,97,38,135,100.00,81.33,166
CZ063,596116,Měřín,698,544,1242,99.36,79.72,1568
CZ063,596132,Mirošov,50,37,87,100.00,76.99,113
CZ063,596141,Moravec,220,163,383,99.74,72.05,533
CZ063,596159,Moravecké Pavlovice,23,15,38,100.00,86.36,44
CZ063,596183,Netín,144,65,209,99.05,77.01,274
CZ063,596205,Nížkov,343,217,560,99.82,75.91,739
CZ063,596213,Nová Ves,34,70,104,97.20,84.92,126
CZ063,596221,Nová Ves u Nového Města na Moravě,339,83,422,99.76,84.60,500
CZ063,596230,Nové Město na Moravě,3765,2127,5892,99.34,73.98,8020
CZ063,596248,Nové Sady,106,46,152,99.35,80.53,190
CZ063,596256,Nové Veselí,594,230,824,99.76,79.12,1044
CZ063,596264,Nový Jimramov,31,22,53,100.00,86.89,61
CZ063,596272,Nyklovice,73,26,99,100.00,77.95,127
CZ063,596281,Obyčtov,148,108,256,100.00,76.88,333
CZ063,596329,Ořechov,115,89,204,99.51,75.93,270
CZ063,596337,Oslavice,288,145,433,99.31,81.65,534
CZ063,596345,Osová Bítýška,306,231,537,100.00,75.53,711
CZ063,596353,Osové,33,25,58,100.00,80.56,72
CZ063,596361,Ostrov nad Oslavou,371,180,551,99.46,75.07,738
CZ063,596370,Otín,115,80,195,100.00,79.27,246
CZ063,596388,Pavlínov,88,70,158,100.00,80.20,197
CZ063,596396,Pavlov,121,76,197,100.00,75.19,262
CZ063,596418,Petráveč,126,46,172,100.00,76.44,225
CZ063,596434,Písečné,78,47,125,100.00,82.78,151
CZ063,596442,Počítky,61,70,131,98.50,73.48,181
CZ063,596451,Poděšín,112,47,159,99.38,80.00,200
CZ063,596469,Podolí,32,23,55,98.21,72.73,77
CZ063,596477,Pokojov,53,30,83,97.65,70.25,121
CZ063,596485,Polnička,302,193,495,99.40,78.67,633
CZ063,596493,Prosetín,161,81,242,98.78,78.53,312
CZ063,596507,Račice,24,3,27,100.00,81.82,33
CZ063,596515,Radenice,68,37,105,99.06,79.10,134
CZ063,596523,Radešín,38,33,71,98.61,71.29,101
CZ063,596531,Radešínská Svratka,260,101,361,99.45,77.90,466
CZ063,596540,Radňoves,33,33,66,98.51,84.81,79
CZ063,596558,Radňovice,149,62,211,99.53,84.46,251
CZ063,596566,Radostín,56,48,104,100.00,80.00,130
CZ063,596574,Radostín nad Oslavou,373,200,573,99.13,80.28,720
CZ063,596604,Rousměrov,38,25,63,100.00,78.75,80
CZ063,596612,Rovečné,202,127,329,99.40,65.23,509
CZ063,596639,Rozseč,27,23,50,100.00,64.10,78
CZ063,596647,Rozsochy,204,204,408,99.27,75.55,544
CZ063,596655,Rožná,235,250,485,99.79,76.18,638
CZ063,596663,Ruda,147,65,212,99.53,69.16,308
CZ063,596671,Rudolec,72,63,135,100.00,75.84,178
CZ063,596680,Řečice,201,77,278,99.64,75.82,368
CZ063,596701,Sázava,275,110,385,99.74,76.89,502
CZ063,596710,Sejřek,67,41,108,100.00,76.60,141
CZ063,596728,Sirákov,98,72,170,100.00,82.52,206
CZ063,596736,Sklené,28,49,77,100.00,92.77,83
CZ063,596744,Sklené nad Oslavou,66,74,140,99.29,73.82,191
CZ063,596752,Skorotice,33,37,70,98.59,73.96,96
CZ063,596761,Skřinářov,51,46,97,100.00,77.60,125
CZ063,596787,Sněžné,301,173,474,98.14,76.55,631
CZ063,596795,Spělkov,14,11,25,100.00,78.13,32
CZ063,596809,Strachujov,31,45,76,98.70,72.64,106
CZ063,596817,Stránecká Zhoř,201,149,350,98.59,76.51,464
CZ063,596825,Strážek,234,255,489,99.80,71.32,687
CZ063,596833,Sulkovec,56,44,100,100.00,68.49,146
CZ063,596841,Světnov,144,121,265,98.88,72.04,372
CZ063,596850,Sviny,43,29,72,98.63,76.04,96
CZ063,596868,Svratka,488,357,845,98.48,75.33,1139
CZ063,596876,Škrdlovice,236,216,452,99.78,81.33,557
CZ063,596884,Štěpánov nad Svratkou,193,211,404,99.75,73.64,550
CZ063,596906,Uhřínov,145,72,217,99.54,80.74,270
CZ063,596914,Ujčov,179,114,293,99.66,79.67,369
CZ063,596922,Újezd,114,45,159,96.95,79.61,206
CZ063,596931,Unčín,54,63,117,100.00,72.22,162
CZ063,596949,Vatín,117,80,197,100.00,75.19,262
CZ063,596957,Věcov,281,163,444,99.55,80.80,552
CZ063,596965,Věchnov,124,86,210,99.53,80.84,261
CZ063,596973,Velká Bíteš,1806,1065,2871,99.48,72.61,3976
CZ063,596981,Velká Losenice,445,246,691,100.00,75.77,912
CZ063,596990,Velké Janovice,47,42,89,100.00,85.58,104
CZ063,597007,Velké Meziříčí,3884,2595,6479,99.52,73.22,8900
CZ063,597015,Vepřová,177,102,279,99.64,80.46,348
CZ063,597031,Věstín,56,49,105,97.22,75.52,143
CZ063,597040,Věžná,97,49,146,99.32,78.61,187
CZ063,597058,Vídeň,178,92,270,99.26,77.49,351
CZ063,597066,Vidonín,40,56,96,100.00,70.59,136
CZ063,597074,Vír,191,220,411,99.52,73.10,565
CZ063,597082,Vlkov,98,65,163,100.00,79.51,205
CZ063,597091,Vojnův Městec,237,227,464,98.93,77.65,604
CZ063,597112,Záblatí,86,68,154,100.00,76.62,201
CZ063,597121,Zadní Zhořec,48,36,84,100.00,84.85,99
CZ063,597139,Znětínek,93,47,140,100.00,86.42,162
CZ063,597147,Zubří,226,119,345,100.00,83.74,412
CZ063,597155,Zvole,227,176,403,100.00,79.33,508
CZ063,597163,Ždánice,83,65,148,100.00,87.57,169
CZ053,504301,Dřenice,115,110,225,100.00,73.53,306
CZ053,504807,Lány,108,64,172,100.00,76.79,224
CZ053,504921,Třibřichy,82,113,195,100.00,84.05,232
CZ053,504955,Dvakačovice,59,41,100,99.01,81.45,124
CZ053,505005,Bítovany,138,113,251,98.82,76.05,334
CZ053,505030,Dolní Bezděkov,73,55,128,100.00,72.73,176
CZ053,530697,Úherčice,54,30,84,98.82,73.28,116
CZ053,547794,Hodonín,31,17,48,100.00,68.57,70
CZ053,547808,Rozhovice,81,87,168,100.00,75.68,222
CZ053,547816,Jeníkov,166,119,285,100.00,78.95,361
CZ053,547824,Křižanovice,46,30,76,100.00,77.55,98
CZ053,547832,Licibořice,100,55,155,98.73,79.29,198
CZ053,547841,Vyžice,89,69,158,100.00,81.87,193
CZ053,547859,Zájezdec,29,34,63,100.00,70.00,90
CZ053,547867,Bor u Skutče,57,36,93,98.94,80.34,117
CZ053,547875,Lipovec,70,79,149,100.00,75.25,198
CZ053,547891,Stolany,130,92,222,99.11,74.92,299
CZ053,554847,Mrákotín,101,105,206,99.52,77.82,266
CZ053,554952,Otradov,91,83,174,99.43,75.43,232
CZ053,556882,Rabštejnská Lhota,352,168,520,99.43,80.21,652
CZ053,571164,Chrudim,7879,4857,12736,99.55,72.48,17652
CZ053,571181,Běstvina,145,161,306,100.00,68.76,445
CZ053,571202,Bojanov,243,154,397,99.25,77.82,514
CZ053,571229,Bořice,60,46,106,100.00,66.25,160
CZ053,571237,Bousov,54,87,141,100.00,76.22,185
CZ053,571245,Bylany,163,107,270,100.00,80.36,336
CZ053,571253,Ctětín,58,104,162,100.00,76.78,211
CZ053,571270,Čankovice,87,68,155,100.00,63.01,246
CZ053,571296,České Lhotice,33,40,73,98.65,77.08,96
CZ053,571300,Dědová,33,55,88,98.88,77.39,115
CZ053,571377,Hamry,54,78,132,100.00,70.21,188
CZ053,571385,Heřmanův Městec,1552,1101,2653,99.66,70.14,3795
CZ053,571393,Hlinsko,2614,2685,5299,99.74,70.36,7554
CZ053,571407,Hluboká,43,62,105,99.06,70.67,150
CZ053,571440,Holetín,221,233,454,99.56,72.73,627
CZ053,571458,Honbice,38,56,94,100.00,63.09,149
CZ053,571466,Horka,154,104,258,99.23,76.70,339
CZ053,571474,Horní Bradlo,134,161,295,99.33,79.41,374
CZ053,571482,Hošťalovice,32,50,82,100.00,73.21,112
CZ053,571491,Hrochův Týnec,557,488,1045,99.81,70.27,1490
CZ053,571504,Hroubovice,97,94,191,100.00,69.96,273
CZ053,571539,Chrast,841,860,1701,99.42,70.61,2423
CZ053,571547,Chroustovice,315,338,653,99.54,67.21,976
CZ053,571563,Jenišovice,157,110,267,99.26,77.75,346
CZ053,571571,Kameničky,297,195,492,99.39,78.32,632
CZ053,571580,Kladno,56,102,158,100.00,80.20,197
CZ053,571610,Kočí,244,170,414,99.76,82.67,502
CZ053,571628,Kostelec u Heřmanova Městce,142,71,213,99.53,74.05,289
CZ053,571652,Krásné,68,42,110,99.10,88.10,126
CZ053,571661,Krouna,488,361,849,99.76,77.08,1104
CZ053,571709,Leštinka,62,40,102,99.03,81.10,127
CZ053,571725,Libkov,31,35,66,100.00,94.29,70
CZ053,571733,Liboměřice,64,40,104,100.00,81.25,128
CZ053,571750,Lozice,49,56,105,100.00,79.55,132
CZ053,571768,Lukavice,292,285,577,99.48,81.92,708
CZ053,571776,Luže,857,732,1589,99.37,72.48,2206
CZ053,571822,Míčov-Sušice,67,90,157,99.37,68.70,230
CZ053,571831,Miřetice,401,384,785,99.87,75.24,1046
CZ053,571857,Mladoňovice,126,91,217,98.19,77.82,284
CZ053,571873,Morašice,265,194,459,99.78,78.36,587
CZ053,571890,Nabočany,21,39,60,96.77,65.26,95
CZ053,571903,Načešice,191,182,373,99.20,74.16,507
CZ053,571911,Nasavrky,549,486,1035,99.81,77.94,1333
CZ053,571962,Orel,254,206,460,99.57,77.26,598
CZ053,572004,Perálec,67,94,161,98.77,78.74,207
CZ053,572039,Podhořany u Ronova,64,96,160,100.00,69.87,229
CZ053,572063,Pokřikov,62,77,139,99.29,67.96,206
CZ053,572071,Prachovice,261,406,667,99.26,61.76,1088
CZ053,572080,Proseč,686,526,1212,99.26,72.16,1692
CZ053,572098,Prosetín,231,248,479,99.38,76.63,629
CZ053,572101,Předhradí,137,99,236,98.33,73.17,328
CZ053,572110,Přestavlky,68,50,118,99.16,67.23,177
CZ053,572152,Raná,113,113,226,100.00,79.37,286
CZ053,572161,Ronov nad Doubravou,421,515,936,99.05,73.94,1278
CZ053,572179,Rosice,394,394,788,99.37,74.46,1065
CZ053,572217,Řestoky,138,143,281,99.65,73.82,382
CZ053,572225,Seč,622,498,1120,99.12,70.27,1611
CZ053,572241,Skuteč,1452,1387,2839,99.51,69.79,4088
CZ053,572268,Slatiňany,1354,965,2319,98.85,74.15,3164
CZ053,572276,Sobětuchy,405,179,584,99.66,79.95,733
CZ053,572314,Střemošice,54,38,92,100.00,65.71,140
CZ053,572322,Studnice,136,142,278,99.64,73.49,381
CZ053,572331,Svídnice,151,119,270,99.26,73.71,369
CZ053,572349,Svratouch,294,247,541,99.63,76.26,712
CZ053,572381,Tisovec,90,89,179,98.90,64.87,279
CZ053,572390,Trhová Kamenice,276,296,572,99.65,71.48,803
CZ053,572403,Trojovice,66,41,107,100.00,71.81,149
CZ053,572411,Třemošnice,875,811,1686,99.70,70.87,2386
CZ053,572420,Tuněchody,169,204,373,99.73,76.33,490
CZ053,572446,Úhřetice,137,125,262,98.87,70.67,375
CZ053,572454,Vápenný Podol,80,85,165,100.00,75.69,218
CZ053,572462,Včelákov,172,173,345,99.71,75.71,457
CZ053,572471,Vejvanovice,106,83,189,100.00,78.75,240
CZ053,572497,Vítanov,131,160,291,100.00,77.39,376
CZ053,572501,Vojtěchov,125,124,249,99.60,77.16,324
CZ053,572527,Vortová,59,82,141,99.30,69.42,206
CZ053,572535,Vrbatův Kostelec,127,120,247,100.00,83.45,296
CZ053,572543,Všeradov,28,67,95,100.00,71.97,132
CZ053,572551,Vysočina,227,252,479,99.58,79.90,602
CZ053,572578,Zaječice,256,311,567,99.65,70.51,807
CZ053,572641,Žumberk,109,90,199,99.50,84.75,236
CZ053,573787,Klešice,135,113,248,100.00,74.47,333
CZ053,573817,Smrček,49,28,77,100.00,77.78,99
CZ053,573876,Zderaz,102,100,202,99.51,88.65,229
CZ053,573949,Biskupice,11,25,36,100.00,60.00,60
CZ053,574007,Kněžice,37,54,91,97.85,78.81,118
CZ053,574091,Žlebské Chvalovice,60,44,104,98.11,90.60,117
CZ053,574104,Ostrov,33,76,109,98.20,68.94,161
CZ053,530794,Trnávka,47,71,118,99.16,71.69,166
CZ053,553719,Srnojedy,310,158,468,99.57,80.20,586
CZ053,555096,Pardubice IV,2009,1123,3132,99.68,77.62,4052
CZ053,555100,Pardubice VI,2322,1245,3567,99.41,75.88,4731
CZ053,555118,Pardubice VII,2466,1306,3772,99.53,77.40,4903
CZ053,555126,Pardubice II,5441,3677,9118,99.49,69.88,13117
CZ053,557064,Pardubice III,5040,3288,8328,99.14,73.32,11460
CZ053,557072,Pardubice V,5420,2868,8288,99.45,70.31,11858
CZ053,574716,Pardubice I,6614,3574,10188,99.43,62.49,16408
CZ053,575020,Pardubice VIII,84,60,144,99.31,70.39,206
CZ053,555134,Pardubice,29396,17141,46537,99.42,70.18,66735
CZ053,572764,Chrtníky,38,24,62,100.00,77.50,80
CZ053,572799,Časy,87,39,126,100.00,75.45,167
CZ053,572802,Malé Výkleky,48,38,86,100.00,85.15,101
CZ053,572845,Lány u Dašic,42,50,92,97.87,81.74,115
CZ053,572853,Pravy,33,23,56,96.55,66.67,87
CZ053,572861,Křičeň,64,73,137,99.28,76.24,181
CZ053,572870,Němčice,356,102,458,98.92,84.80,546
CZ053,572888,Újezd u Sezemic,55,41,96,100.00,64.86,148
CZ053,572896,Černá u Bohdanče,232,136,368,99.73,76.60,483
CZ053,572934,Stéblová,79,70,149,100.00,79.26,188
CZ053,572942,Plch,27,31,58,100.00,81.69,71
CZ053,572951,Podůlšany,62,39,101,100.00,80.16,126
CZ053,572977,Dubany,128,73,201,99.01,86.02,236
CZ053,572985,Třebosice,84,51,135,97.83,73.02,189
CZ053,573019,Holotín,22,13,35,100.00,72.92,48
CZ053,573027,Sovolusky,34,51,85,98.84,78.90,109
CZ053,573035,Morašice,12,53,65,100.00,81.25,80
CZ053,573078,Neratov,60,41,101,100.00,70.63,143
CZ053,573515,Kunětice,129,67,196,98.49,78.66,253
CZ053,574198,Spojil,245,89,334,98.53,79.21,428
CZ053,574724,Barchov,93,74,167,100.00,73.57,227
CZ053,574741,Bezděkov,115,75,190,100.00,75.10,253
CZ053,574767,Lázně Bohdaneč,1308,834,2142,99.44,79.02,2727
CZ053,574783,Borek,140,43,183,98.92,77.73,238
CZ053,574791,Brloh,79,70,149,98.68,79.06,191
CZ053,574805,Břehy,308,323,631,99.37,74.88,848
CZ053,574813,Bukovina nad Labem,83,69,152,98.70,79.79,193
CZ053,574821,Bukovina u Přelouče,21,30,51,100.00,73.91,69
CZ053,574830,Bukovka,132,125,257,99.61,80.63,320
CZ053,574848,Býšť,705,287,992,99.40,82.55,1209
CZ053,574856,Čeperka,473,247,720,99.04,81.71,891
CZ053,574864,Čepí,139,110,249,99.20,73.82,340
CZ053,574899,Dašice,597,560,1157,99.23,72.56,1607
CZ053,574902,Dolany,125,104,229,99.57,68.66,335
CZ053,574911,Dolní Roveň,634,497,1131,99.47,71.78,1584
CZ053,574929,Dolní Ředice,343,242,585,99.83,76.70,764
CZ053,574953,Dříteč,209,101,310,100.00,76.35,406
CZ053,574961,Hlavečník,88,72,160,100.00,73.73,217
CZ053,574988,Holice,2156,1495,3651,99.37,71.55,5135
CZ053,574996,Horní Jelení,663,531,1194,98.92,71.97,1677
CZ053,575011,Horní Ředice,379,215,594,99.17,75.25,796
CZ053,575046,Hrobice,97,51,148,98.67,77.72,193
CZ053,575054,Choltice,380,266,646,99.54,72.19,899
CZ053,575062,Choteč,109,105,214,100.00,80.15,267
CZ053,575071,Chvaletice,672,825,1497,99.60,66.96,2246
CZ053,575089,Chvojenec,256,142,398,99.25,74.67,537
CZ053,575097,Chýšť,79,64,143,100.00,82.18,174
CZ053,575101,Jankovice,81,107,188,99.47,71.86,263
CZ053,575119,Jaroslav,77,70,147,100.00,79.03,186
CZ053,575127,Jedousov,51,41,92,100.00,70.77,130
CZ053,575135,Jeníkovice,62,82,144,99.31,76.72,189
CZ053,575143,Jezbořice,136,98,234,99.15,75.64,312
CZ053,575151,Kasalice,60,61,121,98.37,71.10,173
CZ053,575178,Kladruby nad Labem,173,181,354,99.72,69.47,511
CZ053,575194,Kojice,130,121,251,99.21,72.70,348
CZ053,575232,Kostěnice,203,117,320,100.00,75.47,424
CZ053,575259,Labské Chrčice,107,61,168,99.41,74.45,227
CZ053,575305,Libišany,187,186,373,98.68,78.10,484
CZ053,575313,Lipoltice,135,106,241,99.59,75.16,322
CZ053,575330,Litošice,42,57,99,98.02,77.69,130
CZ053,575372,Mikulovice,465,276,741,99.46,75.40,988
CZ053,575381,Mokošín,64,39,103,99.04,77.04,135
CZ053,575399,Moravany,575,491,1066,99.44,72.78,1473
CZ053,575429,Opatovice nad Labem,996,517,1513,99.61,75.24,2019
CZ053,575437,Ostřešany,407,251,658,99.85,77.80,847
CZ053,575445,Ostřetín,275,262,537,99.81,72.70,740
CZ053,575461,Poběžovice u Holic,117,59,176,100.00,78.57,224
CZ053,575470,Poběžovice u Přelouče,38,32,70,100.00,78.65,89
CZ053,575500,Přelouč,2662,2241,4903,99.63,70.98,6937
CZ053,575518,Přelovice,69,67,136,100.00,72.34,188
CZ053,575526,Přepychy,22,33,55,100.00,85.94,64
CZ053,575534,Ráby,227,102,329,98.80,70.02,477
CZ053,575551,Rohovládova Bělá,223,131,354,99.72,74.27,478
CZ053,575569,Rohoznice,77,98,175,97.77,83.26,215
CZ053,575577,Rokytno,350,169,519,100.00,73.72,704
CZ053,575593,Rybitví,361,343,704,99.29,66.70,1063
CZ053,575607,Řečany nad Labem,467,353,820,99.64,75.57,1089
CZ053,575615,Selmice,31,41,72,100.00,71.29,101
CZ053,575623,Semín,172,200,372,99.47,74.80,500
CZ053,575640,Sezemice,1462,871,2333,99.79,75.08,3114
CZ053,575658,Slepotice,164,102,266,100.00,73.89,360
CZ053,575666,Sopřeč,73,79,152,98.06,71.76,216
CZ053,575682,Srch,688,316,1004,98.92,80.49,1261
CZ053,575704,Staré Hradiště,711,352,1063,99.53,75.11,1422
CZ053,575712,Staré Jesenčany,167,83,250,98.43,78.64,323
CZ053,575721,Staré Ždánice,165,175,340,99.42,71.40,479
CZ053,575739,Starý Mateřov,326,175,501,99.21,81.85,617
CZ053,575755,Stojice,57,61,118,99.16,69.19,172
CZ053,575763,Strašov,137,65,202,98.54,75.37,272
CZ053,575771,Svinčany,146,148,294,98.66,77.60,384
CZ053,575780,Svojšice,79,75,154,99.35,71.10,218
CZ053,575810,Tetov,41,57,98,100.00,69.01,142
CZ053,575828,Trusnov,53,68,121,100.00,70.76,171
CZ053,575844,Turkovice,70,87,157,100.00,67.67,232
CZ053,575879,Uhersko,98,57,155,99.36,74.29,210
CZ053,575887,Úhřetická Lhota,81,90,171,98.84,77.58,223
CZ053,575909,Újezd u Přelouče,51,60,111,98.23,64.57,175
CZ053,575917,Urbanice,24,36,60,100.00,90.91,66
CZ053,575925,Valy,154,136,290,99.32,76.24,383
CZ053,575933,Vápno,36,44,80,100.00,74.77,107
CZ053,575941,Veliny,157,124,281,100.00,74.73,376
CZ053,575968,Veselí,145,99,244,100.00,81.33,300
CZ053,575984,Vlčí Habřina,76,100,176,100.00,71.26,247
CZ053,575992,Voleč,142,84,226,100.00,75.08,301
CZ053,576000,Vysoké Chvojno,125,107,232,99.15,70.69,331
CZ053,576018,Vyšehněvice,97,61,158,100.00,79.00,200
CZ053,576026,Zdechovice,176,189,365,99.46,71.96,510
CZ053,576042,Žáravice,24,45,69,100.00,69.70,99
CZ053,576051,Živanice,336,238,574,100.00,75.93,756
CZ053,505145,Březová nad Svitavou,453,391,844,99.53,69.06,1241
CZ053,505391,Bělá u Jevíčka,82,126,208,100.00,70.75,294
CZ053,572195,Želivsko,15,16,31,96.88,86.49,37
CZ053,572233,Řídký,31,6,37,97.37,69.09,55
CZ053,572250,Březinky,46,25,71,97.26,70.87,103
CZ053,572284,Hartinkov,21,21,42,93.33,84.91,53
CZ053,572292,Vrážné,31,13,44,97.78,88.24,51
CZ053,572357,Desná,164,59,223,99.11,80.36,280
CZ053,572365,Horní Újezd,171,60,231,99.14,73.50,317
CZ053,572373,Poříčí u Litomyšle,220,84,304,99.35,80.53,380
CZ053,572438,Nová Ves u Jarošova,19,24,43,100.00,74.14,58
CZ053,572519,Biskupice,135,122,257,99.23,71.35,363
CZ053,572560,Banín,65,103,168,99.41,70.42,240
CZ053,572586,Bělá nad Svitavou,109,163,272,99.27,69.72,393
CZ053,572594,Kukle,33,17,50,100.00,69.44,72
CZ053,572608,Nová Sídla,74,71,145,98.64,74.62,197
CZ053,572616,Tržek,56,35,91,95.79,73.08,130
CZ053,572624,Útěchov,85,91,176,100.00,72.13,244
CZ053,572632,Borušov,40,61,101,100.00,74.81,135
CZ053,572683,Dětřichov u Moravské Třebové,40,64,104,99.05,68.63,153
CZ053,572691,Hradec nad Svitavou,377,534,911,99.67,69.76,1313
CZ053,572713,Javorník,140,118,258,100.00,76.56,337
CZ053,572721,Opatovec,249,180,429,100.00,76.06,564
CZ053,572730,Chmelík,51,63,114,100.00,75.50,151
CZ053,572748,Karle,88,115,203,99.51,60.36,338
CZ053,574309,Bezděčí u Trnávky,68,65,133,99.25,82.72,162
CZ053,574325,Gruna,61,73,134,100.00,74.44,180
CZ053,574333,Radkov,20,60,80,100.00,82.47,97
CZ053,577731,Svitavy,4600,4182,8782,99.59,68.78,12820
CZ053,577774,Benátky,182,65,247,99.60,80.52,308
CZ053,577812,Bohuňov,45,45,90,98.90,83.49,109
CZ053,577821,Bohuňovice,37,29,66,100.00,70.21,94
CZ053,577839,Borová,379,243,622,99.04,79.09,794
CZ053,577863,Brněnec,281,401,682,98.55,67.12,1031
CZ053,577871,Březina,60,140,200,99.50,71.02,283
CZ053,577898,Březiny,61,32,93,98.94,79.66,118
CZ053,577910,Budislav,158,112,270,99.63,71.88,377
CZ053,577928,Bystré,664,264,928,98.93,73.34,1279
CZ053,577936,Cerekvice nad Loučnou,291,184,475,99.79,75.20,633
CZ053,577944,Čistá,320,220,540,99.63,68.87,787
CZ053,577961,Dětřichov,86,103,189,100.00,71.32,265
CZ053,577987,Dlouhá Loučka,99,219,318,100.00,72.11,441
CZ053,577995,Dolní Újezd,800,355,1155,99.40,76.85,1512
CZ053,578037,Hartmanice,105,68,173,100.00,75.88,228
CZ053,578053,Horky,64,27,91,93.81,88.18,110
CZ053,578096,Chornice,211,244,455,99.56,65.76,695
CZ053,578100,Chotěnov,55,34,89,100.00,82.41,108
CZ053,578118,Chotovice,62,21,83,98.81,67.20,125
CZ053,578126,Chrastavec,75,59,134,99.26,67.84,199
CZ053,578134,Janov,330,211,541,99.45,72.53,750
CZ053,578142,Janůvky,11,20,31,100.00,64.58,48
CZ053,578151,Jaroměřice,304,384,688,99.85,71.03,970
CZ053,578169,Jarošov,66,52,118,99.16,82.07,145
CZ053,578185,Jedlová,294,260,554,99.64,65.80,845
CZ053,578193,Jevíčko,858,768,1626,99.45,71.46,2288
CZ053,578207,Kamenec u Poličky,193,130,323,99.69,73.47,441
CZ053,578215,Kamenná Horka,67,126,193,99.48,70.80,274
CZ053,578231,Koclířov,194,231,425,99.77,74.87,569
CZ053,578258,Korouhev,271,189,460,99.57,74.52,620
CZ053,578266,Koruna,31,52,83,97.65,76.58,111
CZ053,578274,Křenov,81,139,220,99.55,70.03,317
CZ053,578282,Kunčina,290,433,723,98.91,65.74,1112
CZ053,578291,Květná,117,109,226,98.69,72.70,315
CZ053,578304,Lavičné,24,50,74,100.00,71.84,103
CZ053,578339,Linhartice,176,188,364,99.73,72.42,504
CZ053,578347,Litomyšl,3956,1802,5758,99.52,75.38,7677
CZ053,578355,Lubná,397,209,606,99.34,79.53,767
CZ053,578363,Makov,148,57,205,99.51,79.23,260
CZ053,578371,Malíkov,16,49,65,100.00,76.47,85
CZ053,578380,Městečko Trnávka,374,471,845,99.88,74.67,1133
CZ053,578398,Mikuleč,69,88,157,100.00,77.34,203
CZ053,578401,Mladějov na Moravě,82,189,271,100.00,74.66,363
CZ053,578428,Morašice,243,184,427,98.61,75.70,572
CZ053,578444,Moravská Třebová,2604,2685,5289,99.47,67.39,7890
CZ053,578452,Nedvězí,78,43,121,99.18,74.55,165
CZ053,578479,Oldřiš,254,149,403,99.75,76.52,528
CZ053,578487,Opatov,292,309,601,99.34,65.26,927
CZ053,578509,Osík,393,214,607,99.84,76.19,798
CZ053,578550,Pohledy,53,141,194,99.49,75.58,258
CZ053,578576,Polička,3078,1900,4978,99.36,72.23,6936
CZ053,578584,Pomezí,387,305,692,99.86,71.37,971
CZ053,578622,Příluka,72,38,110,100.00,83.33,132
CZ053,578631,Pustá Kamenice,108,66,174,99.43,67.83,258
CZ053,578649,Pustá Rybná,73,31,104,99.05,82.03,128
CZ053,578657,Radiměř,327,330,657,99.39,70.32,940
CZ053,578673,Rohozná,185,186,371,99.73,71.87,519
CZ053,578681,Rozhraní,104,74,178,99.44,71.31,251
CZ053,578690,Rozstání,44,105,149,100.00,76.41,195
CZ053,578703,Rudná,21,54,75,100.00,71.43,105
CZ053,578711,Rychnov na Moravě,127,186,313,99.37,67.02,470
CZ053,578720,Sádek,224,89,313,98.74,78.77,405
CZ053,578738,Sebranice,427,128,555,98.93,75.91,739
CZ053,578746,Sedliště,79,52,131,99.24,68.04,194
CZ053,578754,Sklené,44,69,113,100.00,58.85,192
CZ053,578762,Slatina,43,43,86,100.00,74.14,116
CZ053,578789,Staré Město,255,341,596,99.50,74.97,799
CZ053,578801,Stašov,72,70,142,99.30,70.10,204
CZ053,578819,Strakov,100,62,162,98.78,80.39,204
CZ053,578835,Suchá Lhota,40,24,64,98.46,87.84,74
CZ053,578843,Svojanov,140,84,224,99.56,74.34,304
CZ053,578851,Široký Důl,176,56,232,100.00,74.36,312
CZ053,578860,Študlov,36,35,71,100.00,74.74,95
CZ053,578878,Telecí,166,82,248,99.20,76.22,328
CZ053,578886,Trpín,176,103,279,100.00,79.04,353
CZ053,578894,Trstěnice,160,133,293,99.32,74.87,394
CZ053,578908,Třebařov,165,280,445,100.00,60.79,732
CZ053,578916,Újezdec,40,22,62,100.00,72.94,85
CZ053,578932,Vendolí,236,249,485,99.18,65.20,750
CZ053,578941,Vidlatá Seč,110,65,175,100.00,76.09,230
CZ053,578959,Víska u Jevíčka,36,63,99,100.00,68.75,144
CZ053,578967,Vítějeves,77,146,223,100.00,66.57,335
CZ053,578975,Vranová Lhota,111,134,245,99.59,68.52,359
CZ053,578991,Vysoká,17,9,26,100.00,76.47,34
CZ053,580325,Sloupnice,615,400,1015,99.51,74.62,1367
CZ053,580694,Němčice,346,236,582,100.00,75.29,773
CZ053,581127,Vlčkov,37,25,62,98.41,79.75,79
CZ053,547905,Rybník,251,241,492,99.39,75.00,660
CZ053,547921,Trpík,20,11,31,100.00,53.45,58
CZ053,547964,Sobkovice,97,44,141,100.00,71.57,197
CZ053,547972,Hrádek,44,25,69,100.00,84.15,82
CZ053,547981,Albrechtice,116,135,251,98.82,73.41,346
CZ053,548006,Bošín,27,19,46,95.83,58.54,82
CZ053,548014,Dlouhá Třebová,476,299,775,99.61,76.57,1016
CZ053,548022,Vračovice-Orlov,71,37,108,99.08,76.22,143
CZ053,548031,Dlouhoňovice,265,154,419,98.59,70.48,603
CZ053,548049,Helvíkovice,190,106,296,99.00,77.26,387
CZ053,553760,Běstovice,150,111,261,99.24,76.01,346
CZ053,555240,Semanín,173,181,354,98.88,73.81,485
CZ053,571695,Leština,93,104,197,100.00,73.51,268
CZ053,571920,Nové Hrady,94,66,160,100.00,65.84,243
CZ053,572209,Řepníky,111,115,226,97.84,76.74,301
CZ053,572306,Stradouň,63,48,111,99.11,75.17,149
CZ053,572489,Vinary,41,37,78,98.73,72.48,109
CZ053,573426,Anenská Studánka,32,42,74,100.00,47.13,157
CZ053,574392,Sázava,193,147,340,100.00,75.56,450
CZ053,574449,Kosořín,83,33,116,100.00,79.45,146
CZ053,575542,Radhošť,56,54,110,97.35,86.26,131
CZ053,575861,Týnišťko,41,59,100,100.00,77.52,129
CZ053,579891,Ústí nad Orlicí,4764,3067,7831,99.48,71.85,10960
CZ053,579947,Brandýs nad Orlicí,497,360,857,99.08,74.57,1160
CZ053,579963,Bučina,130,34,164,100.00,83.67,196
CZ053,579971,Bystřec,487,238,725,99.32,82.77,882
CZ053,579980,Cotkytle,91,117,208,100.00,63.80,326
CZ053,579998,Čenkovice,219,60,279,100.00,85.85,325
CZ053,580015,Červená Voda,886,863,1749,99.66,68.35,2569
CZ053,580023,Česká Rybná,131,114,245,99.59,82.00,300
CZ053,580031,Česká Třebová,4730,3825,8555,99.41,72.17,11927
CZ053,580040,České Heřmanice,219,145,364,99.18,79.44,462
CZ053,580058,České Libchavy,229,148,377,99.74,76.99,491
CZ053,580066,České Petrovice,98,36,134,99.26,82.32,164
CZ053,580074,Damníkov,156,214,370,99.73,69.35,535
CZ053,580091,Dobříkov,207,134,341,100.00,80.42,424
CZ053,580112,Dolní Čermná,596,240,836,98.93,80.17,1054
CZ053,580121,Dolní Dobrouč,961,502,1463,99.46,75.32,1953
CZ053,580147,Libchavy,636,418,1054,99.53,77.24,1371
CZ053,580163,Dolní Morava,531,140,671,99.70,87.18,772
CZ053,580210,Džbánov,127,87,214,99.53,77.34,278
CZ053,580228,Hejnice,75,52,127,100.00,76.97,165
CZ053,580261,Hnátnice,281,181,462,98.93,71.85,650
CZ053,580279,Horní Čermná,452,166,618,99.20,77.78,801
CZ053,580295,Horní Heřmanice,150,128,278,99.29,72.16,388
CZ053,580333,Horní Třešňovec,250,145,395,99.50,81.02,490
CZ053,580341,Hrušová,122,108,230,98.71,74.68,312
CZ053,580350,Choceň,2867,1845,4712,99.47,72.41,6542
CZ053,580376,Jablonné nad Orlicí,1067,599,1666,99.64,76.42,2188
CZ053,580392,Jamné nad Orlicí,297,147,444,100.00,79.86,556
CZ053,580406,Javorník,77,69,146,99.32,71.01,207
CZ053,580414,Jehnědí,97,98,195,99.49,75.77,260
CZ053,580422,Kameničná,121,79,200,99.50,75.28,267
CZ053,580431,Klášterec nad Orlicí,323,191,514,99.04,74.04,701
CZ053,580465,Koldín,130,92,222,98.67,82.18,275
CZ053,580481,Králíky,1186,1198,2384,99.58,70.67,3389
CZ053,580490,Krasíkov,71,101,172,100.00,69.35,248
CZ053,580503,Kunvald,423,150,573,98.79,76.02,763
CZ053,580511,Lanškroun,3036,2152,5188,99.23,71.45,7318
CZ053,580538,Letohrad,2659,1059,3718,99.39,76.79,4872
CZ053,580562,Libecina,50,77,127,100.00,85.81,148
CZ053,580571,Lichkov,116,144,260,98.48,63.01,419
CZ053,580589,Líšnice,327,134,461,99.35,75.57,614
CZ053,580619,Lubník,98,89,187,97.40,74.13,259
CZ053,580627,Lukavice,459,249,708,99.16,77.27,924
CZ053,580635,Luková,158,261,419,99.76,72.96,577
CZ053,580643,Mistrovice,226,137,363,99.18,78.21,468
CZ053,580651,Mladkov,180,145,325,98.78,74.77,440
CZ053,580660,Mostek,93,61,154,98.72,79.59,196
CZ053,580678,Nasavrky,31,51,82,100.00,76.64,107
CZ053,580686,Nekoř,403,199,602,99.83,78.82,765
CZ053,580708,Svatý Jiří,123,68,191,99.48,78.69,244
CZ053,580716,Orlické Podhůří,254,149,403,99.26,80.56,504
CZ053,580724,Orličky,105,60,165,99.40,72.81,228
CZ053,580732,Ostrov,187,160,347,99.43,66.73,523
CZ053,580741,Oucmanice,88,49,137,100.00,75.27,182
CZ053,580759,Pastviny,150,70,220,97.78,75.25,299
CZ053,580767,Petrovice,132,43,175,99.43,89.80,196
CZ053,580775,Písečná,241,103,344,99.14,81.07,428
CZ053,580783,Plchovice,18,22,40,100.00,68.97,58
CZ053,580805,Podlesí,114,53,167,100.00,78.40,213
CZ053,580821,Přívrat,169,70,239,99.17,82.82,291
CZ053,580830,Pustina,20,14,34,100.00,66.67,51
CZ053,580848,Rudoltice,491,470,961,99.79,66.41,1450
CZ053,580872,Řetová,246,166,412,98.80,75.54,552
CZ053,580881,Řetůvka,118,48,166,100.00,77.93,213
CZ053,580902,Seč,66,33,99,98.02,78.29,129
CZ053,580929,Skořenice,124,101,225,98.25,73.87,310
CZ053,580945,Slatina,154,123,277,99.64,76.16,365
CZ053,580961,Sopotnice,277,234,511,99.61,72.36,709
CZ053,580970,Sruby,216,126,342,99.71,74.73,459
CZ053,580988,Strážná,42,26,68,100.00,78.16,87
CZ053,580996,Studené,94,30,124,100.00,78.98,157
CZ053,581003,Sudislav nad Orlicí,53,31,84,96.55,75.65,115
CZ053,581011,Sudslava,74,33,107,100.00,74.31,144
CZ053,581038,Šedivec,107,35,142,99.30,86.67,165
CZ053,581046,Tatenice,248,247,495,98.80,71.47,701
CZ053,581054,Těchonín,201,174,375,98.68,77.08,493
CZ053,581062,Tisová,195,135,330,98.80,78.59,425
CZ053,581071,Třebovice,182,271,453,100.00,72.95,621
CZ053,581089,Újezd u Chocně,101,63,164,99.39,64.45,256
CZ053,581101,Velká Skrovnice,106,54,160,98.77,72.00,225
CZ053,581119,Verměřovice,323,129,452,99.78,79.61,569
CZ053,581143,Voděrady,143,84,227,100.00,81.36,279
CZ053,581151,Vraclav,269,171,440,99.32,75.47,587
CZ053,581178,Výprachtice,290,264,554,99.28,74.70,747
CZ053,581186,Vysoké Mýto,3892,2671,6563,99.05,72.34,9165
CZ053,581194,Zádolí,31,36,67,98.53,80.95,84
CZ053,581208,Záchlumí,228,179,407,99.75,72.34,564
CZ053,581216,Zálší,72,62,134,100.00,72.04,186
CZ053,581224,Zámrsk,204,220,424,99.07,71.81,596
CZ053,581232,Zářecká Lhota,73,53,126,99.21,85.81,148
CZ053,581259,Žamberk,2197,1153,3350,99.47,71.99,4680
CZ053,581267,Žampach,91,49,140,100.00,61.57,229
CZ053,581275,Žichlínek,330,218,548,99.64,75.45,729
CZ052,513717,Urbanice,96,97,193,98.97,77.38,252
CZ052,530671,Pšánky,27,22,49,100.00,89.09,55
CZ052,548057,Vrchovnice,24,19,43,97.73,78.57,56
CZ052,548065,Obědovice,115,77,192,99.48,76.59,252
CZ052,548154,Světí,126,59,185,100.00,78.72,235
CZ052,548677,Vysoký Újezd,40,22,62,98.41,79.75,79
CZ052,569810,Hradec Králové,34224,17757,51981,99.49,73.03,71571
CZ052,569828,Babice,67,67,134,100.00,81.71,164
CZ052,569836,Barchov,85,79,164,98.80,81.37,204
CZ052,569852,Běleč nad Orlicí,183,68,251,99.60,79.50,317
CZ052,569861,Benátky,38,31,69,100.00,78.41,88
CZ052,569879,Blešno,179,85,264,98.14,81.27,331
CZ052,569887,Boharyně,175,184,359,98.63,75.83,480
CZ052,569917,Černilov,940,498,1438,98.49,76.69,1905
CZ052,569925,Černožice,338,272,610,99.84,71.11,862
CZ052,569933,Čistěves,77,25,102,100.00,76.12,134
CZ052,569941,Divec,109,45,154,98.09,81.35,193
CZ052,569968,Dobřenice,173,147,320,99.69,72.13,445
CZ052,569976,Dohalice,149,113,262,97.76,74.44,360
CZ052,569984,Dolní Přím,297,169,466,99.57,79.59,588
CZ052,569992,Habřina,88,95,183,97.86,78.57,238
CZ052,570001,Hlušice,183,182,365,99.46,62.63,586
CZ052,570010,Hněvčeves,64,49,113,99.12,82.01,139
CZ052,570028,Holohlavy,291,234,525,99.62,72.99,722
CZ052,570044,Hořiněves,197,188,385,99.74,69.30,557
CZ052,570052,Hrádek,44,75,119,99.17,73.62,163
CZ052,570087,Humburky,121,115,236,100.00,74.45,317
CZ052,570109,Chlumec nad Cidlinou,1714,1301,3015,99.47,71.02,4268
CZ052,570125,Chudeřice,88,55,143,99.31,75.00,192
CZ052,570133,Jeníkovice,155,138,293,99.66,77.78,378
CZ052,570150,Káranice,65,47,112,100.00,73.20,153
CZ052,570168,Klamoš,120,119,239,100.00,72.21,331
CZ052,570176,Kosice,86,132,218,99.54,75.26,291
CZ052,570184,Kosičky,102,105,207,100.00,69.23,299
CZ052,570192,Králíky,90,148,238,99.17,72.73,330
CZ052,570206,Kratonohy,231,135,366,100.00,73.64,497
CZ052,570214,Kunčice,121,86,207,100.00,77.82,266
CZ052,570222,Lejšovka,79,54,133,100.00,75.57,176
CZ052,570231,Lhota pod Libčany,349,228,577,98.97,79.32,735
CZ052,570249,Libčany,278,230,508,99.41,73.42,696
CZ052,570257,Libníkovice,65,42,107,100.00,77.54,138
CZ052,570265,Librantice,274,101,375,99.47,80.73,467
CZ052,570273,Libřice,112,87,199,99.50,84.75,236
CZ052,570290,Lišice,40,62,102,100.00,75.00,136
CZ052,570303,Lodín,156,99,255,100.00,77.27,330
CZ052,570311,Lochenice,235,129,364,99.18,78.42,468
CZ052,570320,Lovčice,222,192,414,99.76,72.93,569
CZ052,570354,Lužany,39,48,87,100.00,76.32,114
CZ052,570362,Lužec nad Cidlinou,137,174,311,99.04,73.88,425
CZ052,570397,Měník,185,214,399,99.25,80.72,498
CZ052,570401,Mlékosrby,85,70,155,99.36,81.25,192
CZ052,570419,Mokrovousy,128,96,224,99.56,78.95,285
CZ052,570427,Myštěves,52,62,114,99.13,79.31,145
CZ052,570435,Mžany,172,96,268,100.00,79.76,336
CZ052,570443,Neděliště,113,106,219,99.55,73.58,299
CZ052,570451,Nechanice,780,558,1338,99.55,74.21,1811
CZ052,570478,Nepolisy,237,363,600,100.00,75.38,796
CZ052,570494,Nové Město,114,128,242,99.18,80.53,303
CZ052,570508,Nový Bydžov,1878,1873,3751,99.34,68.22,5535
CZ052,570516,Ohnišťany,108,88,196,98.99,76.15,260
CZ052,570524,Olešnice,115,73,188,99.47,68.73,275
CZ052,570532,Osice,169,143,312,100.00,76.16,411
CZ052,570541,Osičky,58,39,97,100.00,79.51,122
CZ052,570567,Petrovice,72,114,186,98.41,79.08,239
CZ052,570575,Písek,72,82,154,99.35,73.81,210
CZ052,570648,Prasek,172,211,383,99.22,77.71,498
CZ052,570656,Praskačka,392,267,659,99.40,76.65,865
CZ052,570672,Předměřice nad Labem,707,361,1068,99.26,77.13,1395
CZ052,570681,Převýšov,74,131,205,100.00,73.48,279
CZ052,570702,Račice nad Trotinou,53,49,102,100.00,81.60,125
CZ052,570711,Radíkovice,89,41,130,99.24,81.37,161
CZ052,570729,Radostov,58,31,89,98.89,77.59,116
CZ052,570745,Roudnice,255,170,425,99.77,79.48,536
CZ052,570796,Sendražice,129,100,229,100.00,71.79,319
CZ052,570800,Skalice,217,159,376,99.21,75.20,504
CZ052,570834,Skřivany,296,283,579,99.66,70.00,830
CZ052,570851,Sloupno,165,136,301,100.00,72.18,417
CZ052,570869,Smidary,313,529,842,99.18,67.49,1258
CZ052,570877,Smiřice,833,753,1586,99.62,67.69,2352
CZ052,570885,Smržov,194,121,315,99.68,79.20,399
CZ052,570907,Sovětice,63,65,128,99.22,77.71,166
CZ052,570915,Stará Voda,55,47,102,99.03,83.74,123
CZ052,570931,Stěžery,780,431,1211,98.46,77.12,1595
CZ052,570958,Stračov,97,83,180,100.00,65.69,274
CZ052,570966,Střezetice,151,95,246,100.00,79.87,308
CZ052,571008,Syrovátka,133,108,241,98.77,68.54,356
CZ052,571016,Šaplava,46,27,73,100.00,70.87,103
CZ052,571024,Těchlovice,128,83,211,100.00,75.36,280
CZ052,571041,Třebechovice pod Orebem,2104,1276,3380,99.62,74.28,4568
CZ052,571059,Třesovice,59,87,146,98.65,70.81,209
CZ052,571083,Vinary,112,149,261,100.00,70.73,369
CZ052,571091,Všestary,663,429,1092,99.45,78.82,1393
CZ052,571105,Výrava,149,104,253,99.61,77.68,327
CZ052,571113,Vysoká nad Labem,688,302,990,99.80,79.04,1255
CZ052,571130,Zachrašťany,43,76,119,99.17,71.86,167
CZ052,573132,Starý Bydžov,91,166,257,100.00,74.06,347
CZ052,573191,Sadová,106,99,205,100.00,82.33,249
CZ052,573531,Puchlovice,32,39,71,97.26,73.00,100
CZ052,573621,Hvozdnice,124,54,178,99.44,81.74,219
CZ052,573710,Kobylice,91,65,156,99.36,76.59,205
CZ052,573744,Zdechovice,41,67,108,100.00,78.26,138
CZ052,573779,Máslojedy,75,45,120,100.00,70.59,170
CZ052,576352,Jílovice,132,56,188,98.43,80.25,238
CZ052,576433,Ledce,127,91,218,100.00,78.99,276
CZ052,530735,Staré Hrady,51,72,123,98.40,75.76,165
CZ052,548855,Bříšťany,58,87,145,100.00,70.73,205
CZ052,548863,Milovice u Hořic,91,78,169,98.83,78.44,218
CZ052,548871,Petrovičky,23,7,30,100.00,78.95,38
CZ052,548880,Sukorady,68,70,138,100.00,74.59,185
CZ052,548898,Rokytňany,29,33,62,100.00,63.27,98
CZ052,548901,Bílsko u Hořic,50,28,78,100.00,75.73,103
CZ052,548910,Ohaveč,28,24,52,96.30,85.71,63
CZ052,548928,Kostelec,22,5,27,100.00,79.41,34
CZ052,548944,Kovač,41,48,89,97.80,80.53,113
CZ052,548952,Budčeves,39,49,88,100.00,63.31,139
CZ052,548961,Sedliště,36,36,72,98.63,83.91,87
CZ052,548979,Borek,39,13,52,96.30,66.67,81
CZ052,548995,Červená Třemešná,79,39,118,100.00,84.29,140
CZ052,549029,Vřesník,36,21,57,100.00,72.15,79
CZ052,549037,Choteč,85,54,139,99.29,81.87,171
CZ052,549070,Březina,62,28,90,100.00,84.11,107
CZ052,549088,Dolní Lochov,16,14,30,100.00,81.08,37
CZ052,549096,Staré Místo,79,89,168,99.41,67.87,249
CZ052,549100,Brada-Rybníček,98,21,119,100.00,85.00,140
CZ052,549118,Dílce,17,19,36,100.00,92.31,39
CZ052,549151,Jinolice,86,45,131,98.50,80.12,166
CZ052,549169,Kbelnice,87,48,135,97.83,75.82,182
CZ052,549185,Ohařice,30,19,49,100.00,73.13,67
CZ052,549193,Zámostí-Blata,50,18,68,100.00,71.58,95
CZ052,549207,Nevratice,55,55,110,100.00,74.83,147
CZ052,549223,Chyjice,44,41,85,100.00,66.93,127
CZ052,549274,Rašín,35,25,60,100.00,71.43,84
CZ052,549282,Butoves,75,73,148,99.33,71.63,208
CZ052,549312,Kacákova Lhota,38,56,94,98.95,69.34,137
CZ052,549355,Cholenice,53,78,131,100.00,68.23,192
CZ052,553701,Bačalky,60,49,109,100.00,75.17,145
CZ052,572047,Kyje,38,22,60,100.00,92.31,65
CZ052,572128,Vrbice,39,66,105,100.00,77.21,136
CZ052,572136,Kozojedy,41,53,94,100.00,66.20,142
CZ052,572144,Sekeřice,33,48,81,98.78,82.83,99
CZ052,572187,Slavhostice,28,58,86,100.00,79.63,108
CZ052,572659,Jičín,5168,3714,8882,99.47,72.82,12265
CZ052,572667,Bašnice,58,64,122,100.00,74.39,164
CZ052,572675,Běchary,46,78,124,99.20,58.96,212
CZ052,572705,Boháňka,98,76,174,99.43,84.13,208
CZ052,572756,Tetín,65,28,93,98.94,70.68,133
CZ052,572772,Bystřice,114,91,205,98.56,73.50,283
CZ052,572781,Cerekvice nad Bystřicí,204,242,446,99.55,72.37,619
CZ052,572811,Češov,56,89,145,100.00,79.67,182
CZ052,572829,Dětenice,174,214,388,99.23,67.88,576
CZ052,572837,Dobrá Voda u Hořic,198,143,341,99.13,74.14,464
CZ052,572900,Holín,293,129,422,98.60,83.43,513
CZ052,572918,Holovousy,212,125,337,99.12,79.44,428
CZ052,572926,Hořice,2763,2062,4825,99.44,73.97,6565
CZ052,572969,Chomutice,139,212,351,99.43,73.39,481
CZ052,572993,Jeřice,114,108,222,99.11,69.14,324
CZ052,573001,Jičíněves,159,184,343,99.71,66.09,522
CZ052,573043,Kněžnice,105,61,166,99.40,75.23,222
CZ052,573051,Konecchlumí,140,128,268,100.00,84.54,317
CZ052,573060,Kopidlno,427,625,1052,99.43,63.43,1668
CZ052,573086,Lískovice,70,58,128,100.00,71.91,178
CZ052,573094,Lázně Bělohrad,1497,899,2396,99.42,75.63,3188
CZ052,573108,Libáň,439,502,941,99.47,69.78,1360
CZ052,573116,Libošovice,188,151,339,98.55,79.26,434
CZ052,573124,Libuň,265,190,455,99.78,72.84,626
CZ052,573141,Lukavec u Hořic,117,56,173,99.43,74.04,235
CZ052,573159,Lužany,197,172,369,99.73,76.76,482
CZ052,573167,Markvartice,130,117,247,99.60,64.25,386
CZ052,573175,Miletín,317,214,531,99.44,72.65,735
CZ052,573183,Zelenecká Lhota,38,57,95,98.96,69.57,138
CZ052,573205,Mladějov,191,146,337,99.12,77.10,441
CZ052,573213,Mlázovice,179,143,322,98.77,74.60,437
CZ052,573221,Rohoznice,120,85,205,100.00,82.66,248
CZ052,573230,Nemyčeves,84,121,205,100.00,75.93,270
CZ052,573248,Nová Paka,3127,2007,5134,99.40,72.85,7093
CZ052,573256,Šárovcova Lhota,70,58,128,98.46,78.79,165
CZ052,573264,Osek,71,49,120,100.00,65.57,183
CZ052,573272,Ostroměř,418,338,756,99.60,71.74,1058
CZ052,573281,Ostružno,28,23,51,100.00,61.45,83
CZ052,573299,Pecka,482,309,791,99.75,78.67,1008
CZ052,573302,Svatojanský Újezd,34,16,50,96.15,73.24,71
CZ052,573311,Podhorní Újezd a Vojice,212,167,379,99.48,74.71,510
CZ052,573329,Podhradí,154,116,270,100.00,71.24,379
CZ052,573337,Dřevěnice,117,64,181,99.45,79.82,228
CZ052,573345,Podůlší,100,71,171,100.00,80.28,213
CZ052,573353,Bukvice,38,53,91,96.81,75.81,124
CZ052,573361,Soběraz,37,27,64,98.46,79.27,82
CZ052,573370,Radim,156,114,270,98.54,76.11,360
CZ052,573442,Samšina,74,78,152,99.35,73.21,209
CZ052,573451,Sběř,63,104,167,99.40,67.47,249
CZ052,573469,Slatiny,175,149,324,100.00,72.48,447
CZ052,573477,Sobčice,117,65,182,99.45,76.89,238
CZ052,573493,Sobotka,812,537,1349,99.34,72.04,1885
CZ052,573507,Stará Paka,643,548,1191,99.17,72.39,1659
CZ052,573523,Staré Smrkovice,56,75,131,99.24,63.77,207
CZ052,573540,Střevač,79,85,164,99.39,74.66,221
CZ052,573612,Třebnouševes,83,88,171,99.42,73.19,235
CZ052,573639,Třtěnice,109,104,213,98.61,81.82,264
CZ052,573647,Tuř,42,23,65,100.00,68.42,95
CZ052,573655,Úbislavice,178,124,302,98.37,82.53,372
CZ052,573663,Údrnice,85,100,185,99.46,70.99,262
CZ052,573671,Úhlejov,45,32,77,98.72,66.67,117
CZ052,573680,Újezd pod Troskami,110,86,196,99.49,71.38,276
CZ052,573698,Úlibice,86,88,174,99.43,77.78,225
CZ052,573701,Valdice,480,735,1215,99.84,75.86,1607
CZ052,573728,Veliš,71,54,125,99.21,88.11,143
CZ052,573736,Vidochov,121,74,195,99.49,69.26,283
CZ052,573752,Vitiněves,112,109,221,98.22,78.95,285
CZ052,573761,Volanice,59,75,134,99.26,69.95,193
CZ052,573795,Vršce,36,74,110,100.00,72.37,152
CZ052,573809,Vysoké Veselí,167,252,419,100.00,61.98,676
CZ052,573825,Železnice,426,340,766,99.87,75.49,1016
CZ052,573833,Žeretice,55,68,123,98.40,66.84,187
CZ052,573841,Židovice,19,48,67,100.00,71.28,94
CZ052,573850,Žlunice,66,69,135,100.00,74.18,182
CZ052,505099,Červená Hora,94,37,131,98.50,88.08,151
CZ052,530786,Říkov,88,48,136,100.00,80.95,168
CZ052,547531,Hořenice,52,29,81,100.00,70.43,115
CZ052,547565,Vestec,79,25,104,100.00,71.23,146
CZ052,547646,Velké Poříčí,893,487,1380,99.35,74.68,1860
CZ052,547654,Šestajovice,52,53,105,98.13,76.98,139
CZ052,547701,Libchyně,30,15,45,100.00,70.31,64
CZ052,547727,Sendraž,51,17,68,100.00,80.95,84
CZ052,547743,Vernéřovice,91,85,176,100.00,68.48,257
CZ052,547751,Bukovice,148,61,209,99.52,75.27,279
CZ052,547786,Adršpach,171,104,275,99.28,68.73,403
CZ052,573388,Litoboř,46,15,61,100.00,67.78,90
CZ052,573868,Náchod,6387,4196,10583,99.46,70.60,15084
CZ052,573884,Bezděkov nad Metují,217,137,354,99.16,73.16,488
CZ052,573892,Bohuslavice,391,228,619,99.52,77.75,800
CZ052,573906,Borová,106,38,144,98.63,76.44,191
CZ052,573914,Božanov,99,96,195,100.00,68.42,285
CZ052,573922,Broumov,1728,1803,3531,99.32,62.27,5714
CZ052,573931,Brzice,84,57,141,100.00,76.22,185
CZ052,573957,Černčice,186,86,272,97.84,72.21,385
CZ052,573965,Červený Kostelec,3295,1472,4767,98.94,73.76,6532
CZ052,573973,Česká Čermná,280,50,330,99.70,80.15,413
CZ052,573981,Česká Metuje,73,95,168,99.41,72.53,233
CZ052,573990,Česká Skalice,1559,1175,2734,99.53,68.80,3993
CZ052,574015,Dolany,228,184,412,98.80,78.09,534
CZ052,574023,Dolní Radechová,281,176,457,99.13,76.20,605
CZ052,574031,Hejtmánkovice,156,179,335,99.11,69.55,486
CZ052,574040,Heřmanice,109,123,232,98.72,70.57,333
CZ052,574058,Heřmánkovice,113,157,270,98.90,69.82,391
CZ052,574066,Horní Radechová,176,121,297,99.66,77.00,387
CZ052,574074,Hořičky,226,124,350,99.15,75.75,466
CZ052,574082,Hronov,2231,1172,3403,99.50,70.59,4845
CZ052,574112,Chvalkovice,220,195,415,99.52,69.97,596
CZ052,574121,Jaroměř,3403,2813,6216,99.39,65.84,9505
CZ052,574139,Jasenná,240,184,424,99.30,72.87,586
CZ052,574147,Jestřebí,87,28,115,100.00,88.46,130
CZ052,574155,Jetřichov,114,110,224,99.56,63.03,357
CZ052,574163,Hynčice,33,65,98,100.00,69.01,142
CZ052,574171,Křinice,143,103,246,100.00,71.51,344
CZ052,574180,Lhota pod Hořičkami,76,62,138,99.28,66.19,210
CZ052,574210,Machov,438,195,633,99.22,72.83,876
CZ052,574228,Martínkovice,149,157,306,99.03,71.86,430
CZ052,574236,Mezilečí,51,33,84,98.82,73.91,115
CZ052,574244,Mezilesí,127,40,167,99.40,82.35,204
CZ052,574252,Meziměstí,509,702,1211,99.34,65.05,1874
CZ052,574261,Nahořany,200,137,337,100.00,75.56,446
CZ052,574279,Nové Město nad Metují,3639,1901,5540,99.44,75.34,7394
CZ052,574287,Nový Hrádek,356,150,506,97.87,80.78,640
CZ052,574295,Nový Ples,120,95,215,100.00,76.24,282
CZ052,574317,Otovice,80,94,174,99.43,65.30,268
CZ052,574341,Police nad Metují,1323,857,2180,99.36,69.70,3148
CZ052,574350,Provodov-Šonov,516,274,790,99.62,84.09,943
CZ052,574368,Přibyslav,76,49,125,99.21,76.36,165
CZ052,574376,Rasošky,230,181,411,99.52,75.36,548
CZ052,574384,Rožnov,122,80,202,99.51,66.34,306
CZ052,574406,Rychnovek,217,172,389,98.48,80.28,492
CZ052,574422,Slatina nad Úpou,113,73,186,99.47,78.24,239
CZ052,574431,Slavětín nad Metují,103,48,151,100.00,78.65,192
CZ052,574457,Slavoňov,130,62,192,99.48,77.82,248
CZ052,574465,Stárkov,221,148,369,99.46,74.05,501
CZ052,574481,Studnice,446,244,690,99.71,77.15,897
CZ052,574490,Suchý Důl,169,79,248,99.60,75.68,329
CZ052,574511,Šonov,76,87,163,98.79,67.62,244
CZ052,574538,Teplice nad Metují,464,402,866,99.54,66.59,1308
CZ052,574546,Kramolna,493,204,697,99.57,79.64,879
CZ052,574554,Velichovky,325,217,542,99.27,81.98,666
CZ052,574562,Velká Jesenice,249,170,419,99.52,70.52,597
CZ052,574571,Velké Petrovice,161,93,254,98.45,76.79,336
CZ052,574589,Velký Třebešov,101,74,175,99.43,70.68,249
CZ052,574601,Vlkov,143,77,220,99.55,75.17,294
CZ052,574627,Vršovka,64,22,86,100.00,79.63,108
CZ052,574635,Vysoká Srbská,101,58,159,98.15,71.37,227
CZ052,574643,Vysokov,182,124,306,99.03,78.23,395
CZ052,574651,Zábrodí,252,91,343,100.00,78.85,435
CZ052,574660,Zaloňov,127,122,249,100.00,72.17,345
CZ052,574686,Žďár nad Metují,251,122,373,100.00,73.72,506
CZ052,574694,Žďárky,262,86,348,98.86,74.26,474
CZ052,574708,Žernov,133,47,180,100.00,80.72,223
CZ052,548642,Hřibiny-Ledská,131,74,205,99.03,74.29,280
CZ052,548651,Libel,57,48,105,100.00,82.03,128
CZ052,548669,Rohenice,78,80,158,98.75,71.11,225
CZ052,548685,Krchleby,42,28,70,98.59,81.61,87
CZ052,548693,Svídnice,49,45,94,100.00,75.81,124
CZ052,548707,Vrbice,67,32,99,100.00,82.50,120
CZ052,548723,Polom,50,38,88,98.88,83.96,106
CZ052,548758,Proruby,19,24,43,100.00,91.49,47
CZ052,548782,Jahodov,32,33,65,98.48,83.54,79
CZ052,548791,Chlístov,31,23,54,98.18,78.57,70
CZ052,576069,Rychnov nad Kněžnou,3524,2603,6127,99.30,72.39,8529
CZ052,576077,Albrechtice nad Orlicí,359,182,541,98.90,71.32,767
CZ052,576085,Bačetín,155,94,249,99.20,80.19,313
CZ052,576093,Bartošovice v Orlických horách,144,30,174,98.86,80.00,220
CZ052,576107,Bílý Újezd,211,197,408,98.55,77.09,537
CZ052,576115,Bohdašín,101,45,146,99.32,78.61,187
CZ052,576123,Bolehošť,209,138,347,99.71,74.52,467
CZ052,576131,Borohrádek,563,519,1082,99.82,66.34,1634
CZ052,576140,Borovnice,115,93,208,100.00,67.53,308
CZ052,576166,Bystré,109,63,172,100.00,80.37,214
CZ052,576174,Byzhradec,76,45,121,99.18,75.31,162
CZ052,576182,Častolovice,543,395,938,99.47,74.37,1268
CZ052,576191,Čermná nad Orlicí,286,298,584,100.00,70.45,829
CZ052,576204,Černíkovice,251,215,466,99.79,76.94,607
CZ052,576212,České Meziříčí,554,434,988,99.30,69.00,1442
CZ052,576221,Čestice,206,146,352,99.44,72.54,488
CZ052,576247,Deštné v Orlických horách,614,132,746,99.60,89.19,842
CZ052,576263,Dobré,304,211,515,99.81,77.13,669
CZ052,576271,Dobruška,2384,1390,3774,99.21,73.58,5170
CZ052,576280,Dobřany,55,30,85,100.00,84.16,101
CZ052,576301,Doudleby nad Orlicí,485,505,990,99.20,70.04,1425
CZ052,576310,Chleny,72,44,116,95.87,72.02,168
CZ052,576328,Janov,37,37,74,100.00,85.06,87
CZ052,576336,Javornice,425,221,646,99.69,75.35,860
CZ052,576361,Kostelec nad Orlicí,1890,1477,3367,99.47,71.20,4754
CZ052,576387,Kostelecké Horky,58,30,88,98.88,68.46,130
CZ052,576395,Kounov,100,46,146,100.00,74.49,196
CZ052,576409,Králova Lhota,100,56,156,100.00,78.00,200
CZ052,576425,Kvasiny,396,383,779,99.87,71.17,1096
CZ052,576441,Lhoty u Potštejna,88,86,174,98.31,68.60,258
CZ052,576450,Liberk,261,195,456,99.78,73.71,620
CZ052,576468,Lično,230,141,371,100.00,76.81,483
CZ052,576476,Lípa nad Orlicí,185,124,309,99.68,71.59,433
CZ052,576492,Lukavice,197,182,379,99.48,75.60,504
CZ052,576506,Lupenice,101,76,177,100.00,84.69,209
CZ052,576522,Mokré,42,52,94,96.91,69.29,140
CZ052,576549,Nová Ves,96,53,149,100.00,79.68,187
CZ052,576557,Očelice,87,60,147,99.32,75.51,196
CZ052,576565,Ohnišov,182,112,294,98.00,76.01,396
CZ052,576573,Olešnice v Orlických horách,193,94,287,99.65,67.92,424
CZ052,576581,Olešnice,172,115,287,98.97,76.72,378
CZ052,576590,Opočno,1063,678,1741,99.54,72.60,2409
CZ052,576603,Orlické Záhoří,174,53,227,98.70,79.31,290
CZ052,576611,Osečnice,91,90,181,100.00,80.44,225
CZ052,576620,Pěčín,161,104,265,98.51,68.97,390
CZ052,576654,Podbřezí,210,114,324,98.78,77.00,426
CZ052,576662,Pohoří,256,161,417,100.00,77.08,541
CZ052,576671,Potštejn,370,214,584,98.98,75.45,782
CZ052,576689,Přepychy,187,172,359,99.17,69.22,523
CZ052,576701,Rokytnice v Orlických horách,746,354,1100,99.73,65.46,1685
CZ052,576727,Rybná nad Zdobnicí,124,115,239,100.00,70.09,341
CZ052,576735,Říčky v Orlických horách,243,29,272,100.00,90.37,301
CZ052,576743,Sedloňov,91,62,153,100.00,74.63,205
CZ052,576751,Semechnice,177,104,281,99.65,80.80,349
CZ052,576778,Skuhrov nad Bělou,347,330,677,99.56,76.15,893
CZ052,576786,Slatina nad Zdobnicí,274,214,488,99.80,72.99,670
CZ052,576794,Sněžné,54,34,88,100.00,83.81,105
CZ052,576808,Solnice,554,600,1154,99.23,72.78,1598
CZ052,576816,Synkov-Slemeno,131,103,234,98.32,74.38,320
CZ052,576824,Trnov,293,158,451,100.00,76.83,587
CZ052,576832,Třebešov,111,80,191,99.48,85.33,225
CZ052,576841,Tutleky,100,109,209,99.52,75.54,278
CZ052,576859,Týniště nad Orlicí,2048,1300,3348,99.35,69.98,4816
CZ052,576875,Val,106,82,188,98.43,81.62,234
CZ052,576883,Vamberk,1232,1232,2464,99.39,70.07,3538
CZ052,576891,Voděrady,284,181,465,99.36,81.57,575
CZ052,576921,Záměl,183,210,393,99.49,76.70,515
CZ052,576930,Zdelov,91,77,168,98.82,77.27,220
CZ052,576948,Zdobnice,147,60,207,100.00,80.23,258
CZ052,576956,Žďár nad Orlicí,167,117,284,99.30,68.75,416
CZ052,530808,Královec,54,54,108,100.00,65.45,165
CZ052,546470,Litíč,47,53,100,100.00,75.19,133
CZ052,548804,Lampertice,69,108,177,98.88,57.74,310
CZ052,548812,Stanovice,24,11,35,94.59,80.43,46
CZ052,548821,Borovnička,62,39,101,100.00,63.92,158
CZ052,548839,Zábřezí-Řečice,72,31,103,98.10,88.24,119
CZ052,548847,Zdobín,53,40,93,98.94,81.03,116
CZ052,554863,Dolní Brusnice,135,94,229,98.71,74.12,313
CZ052,574597,Vilantice,74,38,112,100.00,72.73,154
CZ052,579025,Trutnov,10073,6245,16318,99.49,69.41,23638
CZ052,579041,Batňovice,308,166,474,99.79,77.61,612
CZ052,579050,Bernartice,222,254,476,99.17,71.15,676
CZ052,579068,Bílá Třemešná,446,332,778,99.49,73.31,1068
CZ052,579076,Bílé Poličany,39,64,103,100.00,79.84,129
CZ052,579092,Borovnice,130,73,203,99.02,67.21,305
CZ052,579106,Čermná,126,121,247,98.80,75.53,331
CZ052,579114,Černý Důl,472,183,655,99.54,84.90,775
CZ052,579122,Dolní Branná,451,226,677,98.54,79.88,860
CZ052,579149,Dolní Dvůr,192,64,256,99.61,84.26,305
CZ052,579157,Dolní Kalná,244,151,395,99.25,74.95,531
CZ052,579165,Dolní Lánov,240,203,443,99.77,74.62,595
CZ052,579173,Dolní Olešnice,91,126,217,100.00,70.68,307
CZ052,579181,Doubravice,127,105,232,99.15,74.76,313
CZ052,579190,Dubenec,227,189,416,99.76,75.96,549
CZ052,579203,Dvůr Králové nad Labem,5159,3301,8460,99.58,69.33,12255
CZ052,579211,Hajnice,354,218,572,99.65,68.25,841
CZ052,579220,Havlovice,404,220,624,99.68,78.84,794
CZ052,579238,Horní Brusnice,139,110,249,100.00,66.76,373
CZ052,579254,Horní Kalná,143,67,210,99.53,76.17,277
CZ052,579262,Horní Maršov,532,231,763,99.61,77.55,989
CZ052,579271,Horní Olešnice,89,82,171,100.00,67.86,252
CZ052,579297,Hostinné,1176,1207,2383,99.29,68.24,3520
CZ052,579301,Hřibojedy,47,64,111,99.11,67.47,166
CZ052,579319,Chotěvice,222,313,535,100.00,67.72,790
CZ052,579327,Choustníkovo Hradiště,179,122,301,100.00,62.58,481
CZ052,579335,Chvaleč,228,166,394,99.49,71.35,555
CZ052,579351,Janské Lázně,687,176,863,99.31,83.08,1046
CZ052,579378,Jívka,144,156,300,98.36,68.54,445
CZ052,579386,Klášterská Lhota,59,57,116,98.31,67.43,175
CZ052,579394,Kocbeře,173,131,304,99.67,71.43,427
CZ052,579408,Kohoutov,124,58,182,98.91,74.19,248
CZ052,579416,Kuks,86,60,146,100.00,68.54,213
CZ052,579424,Kunčice nad Labem,207,114,321,98.77,70.65,460
CZ052,579432,Lánov,637,361,998,98.91,71.87,1404
CZ052,579441,Lanžov,87,52,139,99.29,76.92,182
CZ052,579475,Libňatov,144,105,249,99.20,82.03,306
CZ052,579483,Libotov,67,49,116,99.15,82.98,141
CZ052,579505,Malá Úpa,486,47,533,99.81,94.51,565
CZ052,579513,Malé Svatoňovice,584,475,1059,99.34,75.41,1415
CZ052,579530,Maršov u Úpice,68,50,118,100.00,78.15,151
CZ052,579548,Mladé Buky,779,515,1294,99.92,68.09,1902
CZ052,579556,Mostek,369,305,674,99.85,68.74,982
CZ052,579564,Nemojov,294,152,446,99.33,73.49,611
CZ052,579581,Pec pod Sněžkou,1672,176,1848,99.46,93.93,1978
CZ052,579599,Pilníkov,353,330,683,98.84,70.73,977
CZ052,579602,Prosečné,171,171,342,99.13,75.99,454
CZ052,579629,Radvanice,285,208,493,99.00,62.38,800
CZ052,579637,Rtyně v Podkrkonoší,1037,632,1669,99.17,71.34,2359
CZ052,579645,Rudník,636,490,1126,99.29,68.40,1658
CZ052,579661,Staré Buky,203,177,380,98.45,77.20,500
CZ052,579696,Strážné,378,46,424,99.30,91.04,469
CZ052,579726,Suchovršice,127,89,216,99.08,75.96,287
CZ052,579734,Svoboda nad Úpou,682,432,1114,99.73,70.14,1594
CZ052,579742,Špindlerův Mlýn,1673,234,1907,99.48,90.64,2116
CZ052,579751,Trotina,25,16,41,100.00,68.33,60
CZ052,579769,Třebihošť,155,106,261,99.62,75.50,347
CZ052,579777,Úpice,1433,1325,2758,99.46,63.88,4341
CZ052,579785,Velké Svatoňovice,417,308,725,99.45,72.11,1011
CZ052,579793,Velký Vřešťov,83,57,140,99.29,68.45,206
CZ052,579815,Vítězná,376,374,750,99.47,65.11,1158
CZ052,579823,Vlčice,179,129,308,98.72,71.07,439
CZ052,579831,Vlčkovice v Podkrkonoší,109,79,188,98.95,62.09,306
CZ052,579858,Vrchlabí,4770,2178,6948,99.47,71.49,9787
CZ052,579866,Zlatá Olešnice,75,56,131,100.00,75.72,173
CZ052,579874,Žacléř,880,712,1592,99.50,62.62,2555
CZ051,513890,Skalka u Doks,38,60,98,100.00,69.50,141
CZ051,514161,Luka,25,31,56,100.00,70.89,79
CZ051,514195,Ždírec,24,37,61,98.39,66.67,93
CZ051,514276,Pertoltice pod Ralskem,87,125,212,100.00,62.91,337
CZ051,530387,Radvanec,101,51,152,99.35,79.27,193
CZ051,544337,Hamr na Jezeře,109,130,239,99.58,67.61,355
CZ051,546232,Kozly,23,65,88,100.00,74.58,118
CZ051,546259,Kvítkov,68,75,143,99.31,75.79,190
CZ051,546267,Tuhaň,75,86,161,100.00,72.52,222
CZ051,546275,Slunečná,54,43,97,97.98,74.44,133
CZ051,546283,Svojkov,135,33,168,100.00,78.87,213
CZ051,553638,Tachov,41,64,105,100.00,59.32,177
CZ051,561380,Česká Lípa,8511,8545,17056,99.65,61.51,27829
CZ051,561398,Bezděz,116,82,198,100.00,65.56,302
CZ051,561401,Blatce,61,36,97,98.98,76.56,128
CZ051,561410,Blíževedly,120,163,283,100.00,60.21,470
CZ051,561428,Bohatice,51,54,105,98.13,62.57,171
CZ051,561444,Brniště,272,446,718,99.45,68.96,1047
CZ051,561479,Cvikov,1113,1218,2331,99.32,65.21,3602
CZ051,561495,Doksy,1499,1262,2761,99.68,66.38,4176
CZ051,561533,Dubá,478,436,914,99.24,66.55,1384
CZ051,561541,Dubnice,151,221,372,99.47,73.19,511
CZ051,561584,Holany,105,194,299,100.00,68.49,438
CZ051,561592,Horní Libchava,287,215,502,100.00,77.47,648
CZ051,561606,Horní Police,184,182,366,99.73,64.96,565
CZ051,561614,Chlum,68,61,129,100.00,62.32,207
CZ051,561622,Chotovice,69,38,107,100.00,72.30,148
CZ051,561665,Jestřebí,180,201,381,99.48,61.77,620
CZ051,561681,Kamenický Šenov,941,1109,2050,99.61,67.04,3070
CZ051,561720,Kravaře,163,255,418,99.76,68.80,609
CZ051,561738,Krompach,85,61,146,99.32,84.48,174
CZ051,561746,Kunratice u Cvikova,119,216,335,99.70,70.74,475
CZ051,561827,Mařenice,115,115,230,99.57,73.57,314
CZ051,561835,Mimoň,1265,1835,3100,99.39,62.08,5026
CZ051,561851,Noviny pod Ralskem,89,94,183,98.39,74.70,249
CZ051,561860,Nový Bor,3524,2863,6387,99.56,68.71,9337
CZ051,561878,Nový Oldřichov,188,242,430,99.54,70.82,610
CZ051,561886,Okna,78,109,187,100.00,74.50,251
CZ051,561894,Okrouhlá,212,117,329,99.10,72.81,456
CZ051,561959,Polevsko,170,76,246,99.60,70.37,351
CZ051,561983,Provodín,169,210,379,99.48,64.91,587
CZ051,561991,Prysk,135,124,259,99.23,71.12,367
CZ051,562017,Ralsko,252,608,860,99.42,50.76,1704
CZ051,562025,Skalice u České Lípy,423,420,843,99.41,68.61,1236
CZ051,562050,Sloup v Čechách,234,174,408,99.76,70.27,582
CZ051,562076,Sosnová,223,185,408,98.79,75.36,548
CZ051,562092,Stráž pod Ralskem,763,1379,2142,99.40,64.60,3336
CZ051,562106,Stružnice,265,305,570,99.48,70.57,812
CZ051,562114,Stvolínky,73,106,179,100.00,71.03,252
CZ051,562131,Svor,218,157,375,98.43,74.41,512
CZ051,562173,Velenice,38,63,101,99.02,70.34,145
CZ051,562203,Velký Valtinov,56,52,108,100.00,66.26,163
CZ051,562220,Volfartice,168,224,392,99.49,69.49,567
CZ051,562238,Vrchovany,29,36,65,100.00,69.15,94
CZ051,562246,Zahrádky,176,152,328,99.39,61.22,539
CZ051,562262,Zákupy,680,826,1506,99.80,66.05,2286
CZ051,562297,Žandov,485,493,978,99.80,63.97,1532
CZ051,530425,Dalešice,107,37,144,100.00,84.71,170
CZ051,546577,Pulečný,154,106,260,99.62,74.36,351
CZ051,546585,Jiřetín pod Bukovou,139,169,308,98.40,71.62,437
CZ051,563510,Jablonec nad Nisou,14373,9293,23666,99.47,68.42,34786
CZ051,563528,Albrechtice v Jizerských horách,375,71,446,99.78,84.98,526
CZ051,563536,Bedřichov,675,79,754,99.74,92.76,815
CZ051,563552,Desná,924,798,1722,99.48,64.94,2667
CZ051,563561,Držkov,200,144,344,99.42,71.05,487
CZ051,563579,Frýdštejn,334,189,523,99.24,76.30,692
CZ051,563595,Janov nad Nisou,577,224,801,99.38,69.01,1168
CZ051,563609,Jenišovice,490,223,713,98.75,78.65,918
CZ051,563617,Jílové u Držkova,65,68,133,98.52,75.00,180
CZ051,563633,Josefův Důl,553,217,770,99.35,77.11,1005
CZ051,563641,Koberovy,402,212,614,99.68,76.33,807
CZ051,563668,Kořenov,976,244,1220,99.67,84.07,1456
CZ051,563676,Líšný,114,49,163,100.00,79.13,206
CZ051,563684,Loužnice,96,46,142,100.00,76.34,186
CZ051,563692,Lučany nad Nisou,750,413,1163,99.40,72.27,1619
CZ051,563706,Malá Skála,546,220,766,99.74,78.63,978
CZ051,563714,Maršovice,253,133,386,99.48,76.73,507
CZ051,563731,Nová Ves nad Nisou,310,198,508,99.61,73.17,697
CZ051,563749,Pěnčín,722,451,1173,99.83,75.66,1553
CZ051,563757,Plavy,359,232,591,99.83,69.40,853
CZ051,563773,Radčice,70,25,95,98.96,72.18,133
CZ051,563781,Rádlo,367,191,558,99.82,77.42,722
CZ051,563790,Rychnov u Jablonce nad Nisou,1006,532,1538,99.29,70.94,2185
CZ051,563803,Skuhrov,244,128,372,99.73,79.53,469
CZ051,563811,Smržovka,1208,812,2020,99.17,69.05,2950
CZ051,563820,Tanvald,1451,1530,2981,99.53,62.51,4791
CZ051,563838,Velké Hamry,729,652,1381,99.78,63.84,2168
CZ051,563846,Vlastiboř,43,46,89,98.89,82.57,109
CZ051,563854,Zásada,368,170,538,99.26,76.08,715
CZ051,563862,Zlatá Olešnice,215,132,347,100.00,75.43,460
CZ051,563871,Železný Brod,1918,1265,3183,99.16,68.63,4677
CZ051,577081,Harrachov,1356,310,1666,99.40,82.92,2038
CZ051,530433,Kunratice,66,126,192,97.96,68.77,285
CZ051,530468,Dlouhý Most,334,200,534,99.63,73.12,733
CZ051,530484,Jeřmanice,232,114,346,99.71,76.43,454
CZ051,544345,Proseč pod Ještědem,136,120,256,99.61,81.59,315
CZ051,544353,Heřmanice,70,89,159,99.38,72.40,221
CZ051,544477,Stráž nad Nisou,908,441,1349,99.41,74.36,1825
CZ051,544531,Čtveřín,224,107,331,99.40,74.83,445
CZ051,544582,Radimovice,151,66,217,98.19,73.42,301
CZ051,544604,Žďárek,84,25,109,99.09,78.57,140
CZ051,545937,Lažany,93,51,144,98.63,78.49,186
CZ051,545953,Paceřice,136,87,223,99.55,80.58,278
CZ051,545996,Černousy,52,100,152,99.35,62.96,243
CZ051,546593,Nová Ves,245,251,496,98.80,68.58,732
CZ051,546607,Dětřichov,158,198,356,99.72,66.36,538
CZ051,546631,Bílý Potok,168,220,388,99.49,69.03,565
CZ051,546658,Janův Důl,60,39,99,99.00,73.53,136
CZ051,561631,Jablonné v Podještědí,988,1010,1998,99.40,68.45,2938
CZ051,561657,Janovice v Podještědí,27,44,71,100.00,81.61,87
CZ051,556891,Liberec-Vratislavice nad Nisou,2862,1742,4604,99.10,69.04,6729
CZ051,556904,Liberec (nečleněné město),31056,17819,48875,99.43,69.07,71208
CZ051,563889,Liberec,33918,19561,53479,99.40,69.07,77937
CZ051,563901,Bílá,309,243,552,98.92,77.07,724
CZ051,563919,Bílý Kostel nad Nisou,310,306,616,99.19,74.85,831
CZ051,563935,Bulovka,151,320,471,99.79,65.10,725
CZ051,563943,Cetenov,39,19,58,96.67,66.67,90
CZ051,563960,Český Dub,922,564,1486,99.60,71.46,2088
CZ051,563994,Dolní Řasnice,106,209,315,99.68,72.37,438
CZ051,564028,Frýdlant,2020,1870,3890,99.64,67.25,5808
CZ051,564036,Habartice,99,162,261,99.62,75.50,347
CZ051,564044,Hejnice,786,702,1488,99.47,67.28,2225
CZ051,564052,Hlavice,82,54,136,99.27,77.84,176
CZ051,564061,Hodkovice nad Mohelkou,954,630,1584,99.25,70.48,2266
CZ051,564079,Horní Řasnice,61,67,128,100.00,67.72,189
CZ051,564095,Hrádek nad Nisou,1898,2056,3954,99.37,65.33,6091
CZ051,564109,Chotyně,293,304,597,99.83,75.06,798
CZ051,564117,Chrastava,1723,1551,3274,99.18,68.66,4809
CZ051,564133,Jindřichovice pod Smrkem,136,157,293,99.32,60.08,491
CZ051,564141,Kobyly,123,88,211,99.06,76.90,277
CZ051,564168,Krásný Les,119,145,264,99.62,65.59,404
CZ051,564176,Kryštofovo Údolí,180,74,254,100.00,78.40,324
CZ051,564184,Křižany,262,201,463,99.36,69.76,668
CZ051,564206,Lázně Libverda,151,134,285,99.65,65.90,434
CZ051,564231,Mníšek,598,347,945,99.47,72.63,1308
CZ051,564265,Nové Město pod Smrkem,660,1102,1762,99.77,60.27,2930
CZ051,564281,Oldřichov v Hájích,252,189,441,99.55,75.47,587
CZ051,564290,Osečná,375,297,672,99.70,72.40,931
CZ051,564303,Pěnčín,319,145,464,99.15,84.02,557
CZ051,564311,Pertoltice,51,113,164,100.00,70.39,233
CZ051,564354,Příšovice,424,328,752,98.82,76.41,996
CZ051,564371,Raspenava,616,784,1400,99.01,64.25,2204
CZ051,564397,Rynoltice,262,221,483,99.18,73.01,667
CZ051,564401,Soběslavice,64,38,102,98.08,76.47,136
CZ051,564427,Světlá pod Ještědem,430,192,622,99.04,77.44,811
CZ051,564435,Svijanský Újezd,171,85,256,98.46,75.80,343
CZ051,564443,Svijany,123,78,201,99.50,78.91,256
CZ051,564451,Sychrov,101,37,138,100.00,77.97,177
CZ051,564460,Šimonovice,645,232,877,99.66,82.24,1070
CZ051,564494,Višňová,258,461,719,99.86,66.76,1080
CZ051,564516,Vlastibořice,154,81,235,99.16,87.13,272
CZ051,564532,Všelibice,166,163,329,100.00,67.01,491
CZ051,564541,Zdislava,97,67,164,99.39,68.46,241
CZ051,547476,Paseky nad Jizerou,234,60,294,97.67,84.79,355
CZ051,547484,Ktová,68,57,125,99.21,77.30,163
CZ051,573400,Loučky,56,37,93,100.00,70.99,131
CZ051,573418,Martinice v Krkonoších,248,124,372,98.15,76.72,494
CZ051,574201,Horka u Staré Paky,98,60,158,99.37,87.85,181
CZ051,576964,Semily,2506,1762,4268,99.09,66.37,6492
CZ051,576972,Bělá,113,58,171,99.42,78.90,218
CZ051,576981,Benecko,828,213,1041,98.67,84.47,1249
CZ051,576999,Benešov u Semil,271,199,470,99.16,71.60,662
CZ051,577006,Bozkov,218,130,348,99.71,73.78,473
CZ051,577014,Bradlecká Lhota,105,54,159,100.00,83.68,190
CZ051,577031,Bukovina u Čisté,84,44,128,97.71,81.88,160
CZ051,577049,Bystrá nad Jizerou,52,22,74,98.67,77.32,97
CZ051,577057,Čistá u Horek,194,141,335,99.11,73.96,457
CZ051,577073,Háje nad Jizerou,228,141,369,99.19,74.10,502
CZ051,577111,Holenice,29,24,53,100.00,73.61,72
CZ051,577120,Horní Branná,828,375,1203,99.34,80.52,1504
CZ051,577146,Hrubá Skála,232,125,357,98.89,70.78,510
CZ051,577154,Chuchelna,382,188,570,99.13,72.97,788
CZ051,577162,Jablonec nad Jizerou,638,350,988,99.40,68.10,1461
CZ051,577171,Jesenný,184,106,290,100.00,71.08,408
CZ051,577189,Jestřabí v Krkonoších,221,53,274,98.92,82.69,335
CZ051,577197,Jilemnice,2155,1007,3162,99.40,72.50,4389
CZ051,577201,Kacanovy,90,36,126,100.00,81.82,154
CZ051,577219,Karlovice,328,181,509,98.83,78.51,656
CZ051,577227,Klokočí,74,64,138,95.17,86.83,167
CZ051,577235,Košťálov,505,390,895,99.44,69.02,1304
CZ051,577243,Kruh,173,125,298,100.00,75.44,395
CZ051,577294,Libštát,314,185,499,98.23,69.30,733
CZ051,577308,Lomnice nad Popelkou,1974,1121,3095,99.33,72.16,4325
CZ051,577316,Mírová pod Kozákovem,730,317,1047,99.05,77.62,1363
CZ051,577324,Modřišice,186,70,256,100.00,77.58,330
CZ051,577332,Mříčná,253,111,364,99.73,77.99,468
CZ051,577341,Nová Ves nad Popelkou,256,139,395,99.75,75.72,523
CZ051,577359,Ohrazenice,454,229,683,98.56,77.17,898
CZ051,577367,Olešnice,79,48,127,96.21,81.99,161
CZ051,577375,Levínská Olešnice,138,80,218,99.09,75.60,291
CZ051,577391,Peřimov,99,56,155,100.00,75.61,205
CZ051,577405,Poniklá,417,279,696,99.29,73.87,949
CZ051,577413,Přepeře,415,190,605,99.83,81.67,742
CZ051,577421,Příkrý,78,74,152,99.35,73.91,207
CZ051,577430,Radostná pod Kozákovem,182,92,274,100.00,76.11,360
CZ051,577448,Rakousy,42,13,55,98.21,70.00,80
CZ051,577456,Rokytnice nad Jizerou,1695,512,2207,99.59,77.84,2847
CZ051,577464,Roprachtice,112,87,199,99.00,82.38,244
CZ051,577472,Rovensko pod Troskami,498,274,772,99.74,72.68,1065
CZ051,577481,Roztoky u Semil,42,28,70,100.00,73.68,95
CZ051,577499,Roztoky u Jilemnice,448,202,650,99.69,81.42,802
CZ051,577529,Slaná,215,151,366,99.46,70.10,525
CZ051,577545,Stružinec,218,203,421,99.76,74.60,567
CZ051,577553,Studenec,769,402,1171,98.57,79.68,1491
CZ051,577561,Svojek,64,44,108,99.08,74.66,146
CZ051,577570,Syřenov,115,36,151,98.69,81.38,188
CZ051,577596,Tatobity,213,142,355,99.44,74.07,482
CZ051,577600,Troskovice,45,25,70,100.00,86.42,81
CZ051,577626,Turnov,5475,2615,8090,99.18,72.83,11215
CZ051,577642,Veselá,79,56,135,99.26,75.14,181
CZ051,577651,Víchová nad Jizerou,326,179,505,98.83,71.57,714
CZ051,577669,Vítkovice,381,72,453,100.00,83.43,543
CZ051,577677,Všeň,224,142,366,99.73,78.09,470
CZ051,577685,Vyskeř,168,95,263,98.87,75.57,352
CZ051,577693,Vysoké nad Jizerou,716,292,1008,99.21,81.41,1248
CZ051,577707,Záhoří,170,117,287,99.31,71.36,405
CZ051,577723,Žernov,48,47,95,100.00,66.67,144
CZ042,530395,Janská,41,83,124,98.41,68.85,183
CZ042,530417,Doubice,66,31,97,100.00,76.98,126
CZ042,544647,Bynovec,104,85,189,99.47,75.10,253
CZ042,544680,Janov,107,119,226,99.12,78.08,292
CZ042,544701,Labská Stráň,58,94,152,99.35,76.50,200
CZ042,545538,Starý Šachov,38,85,123,100.00,68.33,180
CZ042,545678,Markvartice,159,218,377,98.18,68.45,561
CZ042,545708,Lobendava,40,102,142,100.00,65.14,218
CZ042,545783,Dobrná,84,157,241,99.59,70.35,344
CZ042,545791,Merboltice,76,52,128,100.00,71.51,179
CZ042,545856,Dolní Habartice,133,206,339,100.00,71.49,477
CZ042,545899,Františkov nad Ploučnicí,76,139,215,99.54,67.50,320
CZ042,545929,Horní Habartice,78,178,256,99.22,75.66,341
CZ042,546330,Kunratice,61,84,145,100.00,70.05,207
CZ042,546348,Srbská Kamenice,83,86,169,97.13,78.03,223
CZ042,546453,Kámen,63,85,148,100.00,75.13,197
CZ042,546496,Ludvíkovice,240,303,543,100.00,73.38,740
CZ042,555193,Těchlovice,119,164,283,99.30,69.34,411
CZ042,562335,Děčín,11323,12879,24202,99.58,64.85,37487
CZ042,562343,Arnoltice,156,129,285,99.65,82.66,346
CZ042,562351,Benešov nad Ploučnicí,789,1078,1867,99.57,65.40,2867
CZ042,562394,Česká Kamenice,1151,1611,2762,99.50,67.23,4135
CZ042,562408,Dobkovice,126,254,380,99.74,72.99,522
CZ042,562432,Dolní Podluží,250,386,636,100.00,68.35,932
CZ042,562441,Dolní Poustevna,327,394,721,99.45,57.95,1251
CZ042,562483,Heřmanov,83,172,255,100.00,66.58,383
CZ042,562505,Horní Podluží,207,262,469,100.00,70.21,668
CZ042,562513,Hřensko,64,49,113,100.00,61.75,183
CZ042,562521,Huntířov,190,259,449,99.56,69.49,649
CZ042,562530,Chřibská,264,454,718,99.86,66.15,1087
CZ042,562556,Jetřichovice,149,135,284,99.65,80.97,352
CZ042,562564,Jílové,1262,1472,2734,99.67,67.95,4038
CZ042,562572,Jiřetín pod Jedlovou,201,155,356,98.89,70.31,512
CZ042,562581,Jiříkov,592,1106,1698,99.76,59.91,2841
CZ042,562611,Krásná Lípa,761,933,1694,99.47,61.73,2759
CZ042,562645,Kytlice,170,106,276,100.00,66.83,413
CZ042,562661,Lipová,129,185,314,99.68,64.95,485
CZ042,562700,Malá Veleň,137,130,267,99.63,71.85,373
CZ042,562718,Malšovice,263,311,574,99.83,75.26,764
CZ042,562751,Mikulášovice,416,542,958,99.58,57.81,1664
CZ042,562777,Rumburk,2347,2968,5315,99.61,63.06,8466
CZ042,562793,Rybniště,159,220,379,99.74,66.78,569
CZ042,562823,Staré Křečany,235,321,556,99.82,54.82,1016
CZ042,562858,Šluknov,869,1613,2482,99.60,56.96,4375
CZ042,562874,Valkeřice,88,145,233,100.00,73.73,316
CZ042,562882,Varnsdorf,3120,4216,7336,99.67,62.74,11743
CZ042,562891,Velká Bukovina,139,134,273,98.91,65.87,419
CZ042,562912,Velký Šenov,382,612,994,99.90,63.26,1576
CZ042,562921,Verneřice,222,392,614,100.00,67.92,904
CZ042,562939,Veselé,80,125,205,99.51,67.32,306
CZ042,562947,Vilémov,178,271,449,100.00,62.71,716
CZ042,566900,Růžová,185,135,320,100.00,67.23,476
CZ042,546062,Pesvice,68,52,120,98.36,77.22,158
CZ042,546071,Račetice,75,186,261,100.00,76.76,340
CZ042,546160,Nezabylice,67,86,153,99.35,73.81,210
CZ042,546518,Loučná pod Klínovcem,214,59,273,99.64,88.67,309
CZ042,562971,Chomutov,9655,12177,21832,99.67,61.00,35922
CZ042,562980,Bílence,53,101,154,100.00,77.78,198
CZ042,562998,Blatno,204,159,363,99.73,77.12,472
CZ042,563005,Boleboř,103,107,210,100.00,76.36,275
CZ042,563013,Březno,303,467,770,99.48,69.17,1119
CZ042,563021,Černovice,169,219,388,99.49,74.86,521
CZ042,563048,Domašín,38,59,97,100.00,63.82,152
CZ042,563056,Droužkovice,239,232,471,99.79,74.92,630
CZ042,563064,Hora Svatého Šebestiána,96,84,180,100.00,66.91,269
CZ042,563072,Hrušovany,68,186,254,99.61,64.23,397
CZ042,563081,Chbany,103,249,352,100.00,66.92,526
CZ042,563099,Jirkov,3626,5042,8668,99.67,59.08,14729
CZ042,563102,Kadaň,3766,4344,8110,99.62,61.14,13316
CZ042,563111,Kalek,80,61,141,99.30,66.67,213
CZ042,563129,Klášterec nad Ohří,3120,3669,6789,99.65,60.41,11287
CZ042,563137,Kovářská,243,300,543,99.09,61.48,893
CZ042,563161,Křimov,71,116,187,100.00,59.18,316
CZ042,563188,Libědice,67,98,165,99.40,78.30,212
CZ042,563200,Málkov,247,314,561,99.29,74.24,761
CZ042,563218,Mašťov,110,228,338,99.71,72.13,470
CZ042,563226,Měděnec,59,50,109,100.00,78.42,139
CZ042,563242,Místo,126,138,264,100.00,74.37,355
CZ042,563269,Okounov,129,134,263,99.25,77.94,340
CZ042,563277,Otvice,219,225,444,99.55,79.64,560
CZ042,563285,Perštejn,452,303,755,99.47,77.37,981
CZ042,563293,Pětipsy,27,72,99,100.00,63.06,157
CZ042,563315,Kryštofovy Hamry,53,41,94,100.00,78.33,120
CZ042,563323,Radonice,203,434,637,99.38,68.26,939
CZ042,563331,Rokle,67,105,172,100.00,57.53,299
CZ042,563340,Spořice,483,388,871,99.54,73.53,1190
CZ042,563358,Strupčice,274,350,624,99.52,77.70,807
CZ042,563382,Údlice,371,356,727,99.73,74.16,983
CZ042,563404,Vejprty,410,722,1132,99.65,49.01,2318
CZ042,563412,Veliká Ves,53,109,162,100.00,62.55,259
CZ042,563439,Vilémov,96,268,364,100.00,73.68,494
CZ042,563463,Vrskmaň,72,130,202,99.02,75.28,271
CZ042,563471,Všehrdy,52,275,327,98.79,78.44,422
CZ042,563480,Všestudy,29,82,111,100.00,75.51,147
CZ042,563498,Výsluní,91,87,178,100.00,71.77,248
CZ042,563501,Vysoká Pec,400,301,701,99.43,76.80,918
CZ042,505528,Jenčice,118,88,206,100.00,75.46,273
CZ042,530506,Miřejovice,89,52,141,100.00,77.90,181
CZ042,542407,Trnovany,139,108,247,99.60,73.37,338
CZ042,542423,Černouček,252,25,277,99.64,89.68,310
CZ042,542440,Oleško,37,23,60,100.00,70.59,85
CZ042,542482,Záluží,76,46,122,100.00,79.74,153
CZ042,542491,Malíč,68,35,103,100.00,68.67,150
CZ042,542521,Michalovice,51,48,99,100.00,77.34,128
CZ042,542539,Píšťany,44,85,129,99.23,72.22,180
CZ042,546691,Lkáň,35,65,100,100.00,71.43,140
CZ042,546721,Sedlec,60,58,118,99.16,65.75,181
CZ042,546755,Brzánky,29,20,49,100.00,70.00,70
CZ042,546763,Horní Řepčice,24,36,60,100.00,76.92,78
CZ042,546771,Kamýk,59,46,105,98.13,70.39,152
CZ042,546780,Býčkovice,59,104,163,100.00,66.80,244
CZ042,546810,Chudoslavice,46,46,92,98.92,74.40,125
CZ042,546828,Staňkovice,21,3,24,100.00,82.76,29
CZ042,546852,Černěves,93,44,137,99.28,75.41,183
CZ042,553646,Dolánky nad Ohří,71,78,149,100.00,67.42,221
CZ042,564567,Litoměřice,7499,5076,12575,99.63,69.51,18163
CZ042,564575,Bechlín,364,382,746,99.20,74.41,1016
CZ042,564591,Bohušovice nad Ohří,683,658,1341,99.78,70.36,1913
CZ042,564613,Brňany,107,151,258,97.36,73.20,362
CZ042,564621,Brozany nad Ohří,359,314,673,99.70,69.44,972
CZ042,564648,Bříza,120,121,241,100.00,72.59,332
CZ042,564656,Budyně nad Ohří,651,552,1203,99.75,70.28,1716
CZ042,564672,Ctiněves,173,58,231,100.00,76.24,303
CZ042,564699,Černiv,42,52,94,100.00,69.63,135
CZ042,564711,Čížkovice,290,463,753,99.74,66.17,1141
CZ042,564729,Děčany,69,142,211,99.53,69.74,304
CZ042,564737,Dlažkovice,27,54,81,98.78,79.61,103
CZ042,564745,Dobříň,212,108,320,99.07,74.42,434
CZ042,564753,Doksany,152,105,257,100.00,73.22,351
CZ042,564770,Drahobuz,55,99,154,99.35,68.58,226
CZ042,564818,Dušníky,113,101,214,100.00,72.64,296
CZ042,564834,Evaň,80,99,179,98.90,71.83,252
CZ042,564842,Hlinná,119,55,174,98.86,73.64,239
CZ042,564851,Horní Beřkovice,374,315,689,99.86,77.79,887
CZ042,564877,Hoštka,487,423,910,99.34,70.03,1308
CZ042,564893,Hrobce,229,177,406,99.75,75.65,538
CZ042,564923,Chodouny,222,166,388,99.74,72.57,536
CZ042,564931,Chodovlice,37,52,89,100.00,72.95,122
CZ042,564940,Chotěšov,125,146,271,100.00,67.08,404
CZ042,564958,Chotiměř,64,107,171,99.42,72.88,236
CZ042,564966,Chotiněves,69,41,110,100.00,66.67,165
CZ042,565016,Keblice,83,132,215,99.54,70.13,308
CZ042,565024,Klapý,128,147,275,100.00,71.99,382
CZ042,565032,Kleneč,184,160,344,99.71,77.18,447
CZ042,565059,Kostomlaty pod Řípem,98,123,221,99.55,66.07,336
CZ042,565067,Krabčice,365,173,538,99.63,73.47,735
CZ042,565075,Křesín,83,102,185,100.00,67.77,273
CZ042,565083,Křešice,388,419,807,99.14,69.87,1165
CZ042,565091,Kyškovice,119,69,188,98.95,76.61,248
CZ042,565105,Levín,43,61,104,100.00,78.79,132
CZ042,565113,Lhotka nad Labem,105,89,194,99.49,76.56,256
CZ042,565121,Liběšice,357,435,792,99.75,63.80,1246
CZ042,565148,Libkovice pod Řípem,149,137,286,99.31,67.21,430
CZ042,565156,Libochovany,182,161,343,99.42,72.18,478
CZ042,565164,Libochovice,922,895,1817,99.78,66.18,2753
CZ042,565172,Libotenice,138,133,271,99.27,80.53,339
CZ042,565211,Lovečkovice,125,219,344,99.71,72.69,476
CZ042,565229,Lovosice,1935,2350,4285,99.67,64.36,6695
CZ042,565237,Lukavec,72,154,226,100.00,77.40,292
CZ042,565245,Malé Žernoseky,187,240,427,98.61,74.27,583
CZ042,565253,Martiněves,296,191,487,99.19,75.08,654
CZ042,565296,Mlékojedy,55,61,116,99.15,61.26,191
CZ042,565300,Mnetěš,266,76,342,99.13,81.37,424
CZ042,565318,Mšené-lázně,584,488,1072,99.44,72.30,1491
CZ042,565342,Nové Dvory,104,116,220,100.00,71.66,307
CZ042,565393,Ploskovice,131,122,253,100.00,71.27,355
CZ042,565415,Podsedice,172,249,421,99.06,77.98,545
CZ042,565431,Polepy,347,390,737,99.46,70.30,1054
CZ042,565458,Prackovice nad Labem,157,201,358,99.72,67.86,529
CZ042,565474,Přestavlky,94,64,158,99.37,73.95,215
CZ042,565482,Račice,117,111,228,97.85,79.79,292
CZ042,565491,Račiněves,163,179,342,100.00,73.55,465
CZ042,565521,Radovesice,115,179,294,100.00,75.58,389
CZ042,565547,Rochov,34,52,86,100.00,78.18,110
CZ042,565555,Roudnice nad Labem,4361,2492,6853,99.67,70.74,9720
CZ042,565598,Siřejovice,63,102,165,100.00,73.01,226
CZ042,565601,Slatina,76,84,160,100.00,73.73,217
CZ042,565610,Snědovice,183,234,417,100.00,66.51,627
CZ042,565679,Straškov-Vodochody,362,301,663,99.85,79.93,832
CZ042,565695,Sulejovice,160,258,418,99.52,74.34,565
CZ042,565709,Štětí,1968,2141,4109,99.54,62.85,6570
CZ042,565717,Terezín,766,746,1512,99.67,66.61,2279
CZ042,565741,Travčice,241,142,383,98.97,78.86,492
CZ042,565768,Třebenice,507,540,1047,100.00,72.86,1437
CZ042,565776,Třebívlice,204,313,517,99.42,74.29,700
CZ042,565792,Třebušín,162,152,314,100.00,67.97,462
CZ042,565806,Úpohlavy,89,68,157,99.37,74.18,213
CZ042,565814,Úštěk,730,800,1530,99.54,67.83,2266
CZ042,565831,Vědomice,382,194,576,99.83,80.36,718
CZ042,565849,Velemín,403,538,941,99.47,72.57,1305
CZ042,565857,Velké Žernoseky,133,139,272,99.63,68.25,400
CZ042,565865,Vchynice,97,81,178,100.00,66.17,269
CZ042,565873,Vlastislav,44,52,96,98.97,65.10,149
CZ042,565881,Vražkov,127,119,246,99.60,72.86,339
CZ042,565890,Vrbice,163,140,303,99.34,72.62,420
CZ042,565903,Vrbičany,59,96,155,93.94,66.27,249
CZ042,565911,Vrutice,64,98,162,99.39,67.08,243
CZ042,565938,Žabovřesky nad Ohří,72,88,160,99.38,78.54,205
CZ042,565946,Žalhostice,128,171,299,99.67,69.93,429
CZ042,565954,Židovice,135,78,213,100.00,70.07,304
CZ042,565962,Žitenice,507,402,909,99.24,72.64,1261
CZ042,530557,Kozly,26,53,79,98.75,74.77,107
CZ042,530565,Želkovice,19,45,64,100.00,85.33,75
CZ042,530581,Čeradice,60,116,176,100.00,73.33,240
CZ042,530590,Libočany,105,214,319,99.69,74.13,433
CZ042,530603,Zálužice,12,38,50,100.00,72.46,69
CZ042,542547,Blšany u Loun,114,119,233,100.00,76.64,304
CZ042,542555,Opočno,22,47,69,100.00,69.00,100
CZ042,542571,Cítoliby,301,280,581,99.15,71.46,820
CZ042,542580,Obora,155,115,270,99.63,80.90,335
CZ042,542628,Černčice,344,390,734,99.59,69.53,1060
CZ042,542636,Nová Ves,14,47,61,100.00,71.76,85
CZ042,543012,Žerotín,68,81,149,100.00,84.66,176
CZ042,543128,Staňkovice,245,366,611,99.51,70.41,872
CZ042,546011,Jimlín,188,293,481,99.79,70.47,684
CZ042,546178,Úherce,27,23,50,100.00,70.42,71
CZ042,546429,Chraberce,41,38,79,100.00,75.96,104
CZ042,546861,Dobroměřice,340,510,850,99.07,76.74,1118
CZ042,546879,Líšťany,130,155,285,100.00,73.83,386
CZ042,546887,Vršovice,60,79,139,100.00,70.56,197
CZ042,546895,Brodec,23,34,57,100.00,76.00,75
CZ042,565971,Louny,4481,4642,9123,99.63,64.69,14159
CZ042,565997,Bitozeves,87,158,245,100.00,67.31,364
CZ042,566004,Blatno,100,200,300,99.67,74.14,406
CZ042,566012,Blažim,52,107,159,100.00,74.65,213
CZ042,566021,Blšany,198,360,558,99.47,70.74,793
CZ042,566063,Břvany,39,138,177,100.00,67.56,262
CZ042,566128,Deštnice,33,90,123,99.19,68.51,181
CZ042,566152,Domoušice,148,218,366,100.00,69.98,523
CZ042,566187,Holedeč,159,213,372,99.20,73.53,510
CZ042,566195,Hříškov,101,141,242,100.00,73.78,328
CZ042,566217,Hřivice,196,197,393,99.49,75.38,524
CZ042,566233,Chlumčany,169,169,338,99.71,72.90,465
CZ042,566241,Chožov,107,146,253,100.00,59.95,422
CZ042,566284,Koštice,145,195,340,100.00,65.96,517
CZ042,566306,Krásný Dvůr,134,227,361,99.72,67.66,535
CZ042,566314,Kryry,431,874,1305,99.69,69.85,1874
CZ042,566322,Lenešice,336,409,745,99.60,67.09,1115
CZ042,566349,Libčeves,166,317,483,98.77,67.36,726
CZ042,566357,Liběšice,162,313,475,99.79,76.53,622
CZ042,566381,Libořice,41,144,185,100.00,67.77,273
CZ042,566403,Lipno,120,186,306,100.00,66.09,463
CZ042,566411,Lišany,10,84,94,100.00,74.80,127
CZ042,566438,Lubenec,249,600,849,99.41,71.11,1201
CZ042,566454,Měcholupy,189,325,514,100.00,67.19,765
CZ042,566501,Nepomyšl,72,154,226,98.69,67.35,340
CZ042,566519,Nové Sedlo,131,375,506,99.80,67.78,748
CZ042,566527,Očihov,52,151,203,100.00,69.05,294
CZ042,566535,Panenský Týnec,164,94,258,100.00,72.68,355
CZ042,566551,Peruc,660,666,1326,99.33,70.13,1905
CZ042,566560,Petrohrad,118,250,368,99.73,66.13,558
CZ042,566578,Pnětluky,89,136,225,100.00,74.26,303
CZ042,566586,Počedělice,67,111,178,98.89,73.47,245
CZ042,566608,Podbořanský Rohozec,34,64,98,98.99,73.33,135
CZ042,566616,Podbořany,1207,2081,3288,99.61,67.02,4930
CZ042,566624,Postoloprty,715,1477,2192,99.73,61.31,3590
CZ042,566659,Raná,64,80,144,100.00,72.36,199
CZ042,566667,Ročov,161,176,337,99.70,73.16,462
CZ042,566713,Slavětín,169,177,346,98.86,71.28,491
CZ042,566721,Smolnice,120,143,263,99.25,77.03,344
CZ042,566829,Toužetín,48,102,150,100.00,64.38,233
CZ042,566853,Tuchořice,164,228,392,99.24,70.16,563
CZ042,566870,Velemyšleves,38,150,188,98.95,66.43,286
CZ042,566896,Veltěže,55,159,214,99.53,63.61,338
CZ042,566918,Vinařice,79,90,169,100.00,77.88,217
CZ042,566926,Vrbno nad Lesy,46,68,114,100.00,65.14,175
CZ042,566934,Vroutek,366,660,1026,99.61,69.08,1491
CZ042,566951,Výškov,107,186,293,100.00,73.87,398
CZ042,566977,Zbrašín,98,143,241,99.59,77.81,311
CZ042,566985,Žatec,4059,5394,9453,99.67,65.52,14479
CZ042,567019,Žiželice,60,169,229,100.00,67.55,339
CZ042,546437,Volevčice,19,54,73,98.65,74.00,100
CZ042,567027,Most,12245,17086,29331,99.69,59.36,49576
CZ042,567043,Bečov,172,512,684,99.71,57.84,1186
CZ042,567051,Bělušice,93,264,357,100.00,60.30,592
CZ042,567060,Braňany,169,467,636,100.00,64.77,982
CZ042,567078,Brandov,78,95,173,100.00,75.88,228
CZ042,567108,Český Jiřetín,46,37,83,100.00,79.81,104
CZ042,567141,Havraň,118,234,352,99.72,73.39,481
CZ042,567167,Hora Svaté Kateřiny,138,114,252,100.00,71.07,356
CZ042,567175,Horní Jiřetín,445,646,1091,99.91,63.23,1727
CZ042,567191,Klíny,84,56,140,99.29,80.57,175
CZ042,567221,Korozluky,80,69,149,100.00,76.41,195
CZ042,567248,Lišnice,50,67,117,100.00,66.10,177
CZ042,567256,Litvínov,4354,6377,10731,99.44,58.85,18350
CZ042,567264,Lom,844,1158,2002,99.50,67.87,2966
CZ042,567272,Louka u Litvínova,161,234,395,100.00,66.00,600
CZ042,567281,Lužice,158,213,371,99.46,81.80,456
CZ042,567299,Malé Březno,56,81,137,100.00,71.35,192
CZ042,567302,Mariánské Radčice,95,158,253,97.68,70.57,367
CZ042,567311,Meziboří,1057,1500,2557,99.57,67.08,3833
CZ042,567329,Nová Ves v Horách,136,141,277,99.64,66.51,418
CZ042,567337,Obrnice,154,562,716,99.86,44.50,1618
CZ042,567345,Patokryje,118,152,270,99.63,71.13,381
CZ042,567353,Polerady,55,87,142,100.00,77.60,183
CZ042,567361,Skršín,88,88,176,98.88,74.17,240
CZ042,567426,Želenice,90,201,291,99.66,68.38,427
CZ042,546909,Lukov,30,48,78,98.73,68.10,116
CZ042,567442,Teplice,11414,12165,23579,99.70,62.05,38140
CZ042,567451,Bílina,2104,4575,6679,99.70,58.76,11405
CZ042,567469,Bořislav,132,121,253,99.22,74.78,341
CZ042,567477,Bystřany,513,572,1085,99.82,66.97,1623
CZ042,567485,Bžany,249,302,551,99.82,75.10,735
CZ042,567507,Dubí,1683,2267,3950,99.55,63.22,6278
CZ042,567515,Duchcov,1348,2771,4119,99.73,61.25,6743
CZ042,567523,Háj u Duchcova,355,349,704,99.72,68.48,1031
CZ042,567531,Hostomice,165,433,598,99.83,62.66,956
CZ042,567558,Hrob,463,609,1072,99.44,68.44,1575
CZ042,567566,Hrobčice,203,401,604,99.83,67.30,899
CZ042,567582,Jeníkov,220,250,470,100.00,64.65,727
CZ042,567604,Kladruby,123,123,246,98.80,73.67,338
CZ042,567612,Kostomlaty pod Milešovkou,214,304,518,100.00,68.70,754
CZ042,567621,Košťany,644,1022,1666,99.88,66.88,2494
CZ042,567639,Krupka,2568,3551,6119,99.61,60.87,10104
CZ042,567647,Lahošť,118,220,338,99.41,65.13,522
CZ042,567655,Ledvice,85,189,274,98.92,65.48,423
CZ042,567698,Měrunice,75,121,196,100.00,72.06,272
CZ042,567701,Mikulov,105,63,168,99.41,82.04,206
CZ042,567710,Modlany,319,325,644,100.00,73.80,874
CZ042,567728,Moldava,102,55,157,100.00,78.89,199
CZ042,567752,Novosedlice,480,614,1094,99.45,64.03,1718
CZ042,567761,Ohníč,182,195,377,99.47,64.57,587
CZ042,567779,Osek,1013,1416,2429,99.35,63.62,3843
CZ042,567787,Proboštov,864,755,1619,99.63,73.91,2200
CZ042,567809,Rtyně nad Bílinou,200,249,449,98.68,71.09,640
CZ042,567833,Srbice,124,146,270,100.00,74.25,365
CZ042,567841,Světec,166,362,528,99.62,67.94,783
CZ042,567850,Újezdeček,168,265,433,99.31,60.64,719
CZ042,567868,Zabrušany,241,417,658,99.40,70.28,942
CZ042,567876,Žalany,168,129,297,99.00,72.29,415
CZ042,567884,Žim,70,66,136,100.00,72.73,187
CZ042,530620,Přestanov,174,159,333,99.70,79.33,421
CZ042,546186,Ryjice,56,91,147,100.00,76.56,192
CZ042,546925,Stebno,110,164,274,99.64,68.58,401
CZ042,553697,Trmice,445,859,1304,99.62,55.56,2356
CZ042,501298,Ústí nad Labem-Severní Terasa,4704,5053,9757,99.64,65.08,15059
CZ042,502081,Ústí nad Labem-Neštěmice,3702,5934,9636,99.52,55.74,17384
CZ042,502316,Ústí nad Labem-Střekov,3606,3497,7103,99.38,64.99,11001
CZ042,567892,Ústí nad Labem-město,9829,7258,17087,99.63,64.32,26687
CZ042,554804,Ústí nad Labem,21841,21742,43583,99.57,62.46,70131
CZ042,555223,Velké Chvojno,230,244,474,99.79,71.00,669
CZ042,567931,Dolní Zálezly,180,169,349,100.00,72.56,481
CZ042,567957,Habrovany,44,87,131,100.00,75.72,173
CZ042,567973,Homole u Panny,97,155,252,99.60,78.09,324
CZ042,568007,Chabařovice,638,756,1394,99.50,69.19,2025
CZ042,568015,Chlumec,1206,1183,2389,99.29,69.81,3448
CZ042,568023,Chuderov,381,269,650,99.69,73.59,886
CZ042,568058,Libouchec,570,511,1081,99.08,71.83,1523
CZ042,568091,Malé Březno,126,161,287,99.31,66.59,434
CZ042,568104,Malečov,276,232,508,99.61,74.34,686
CZ042,568147,Petrovice,192,222,414,97.87,66.25,640
CZ042,568155,Povrly,599,585,1184,99.33,65.82,1811
CZ042,568201,Řehlovice,400,427,827,99.76,70.76,1173
CZ042,568287,Tašov,40,49,89,100.00,78.07,114
CZ042,568295,Telnice,179,238,417,99.29,70.83,593
CZ042,568309,Tisá,431,179,610,99.51,74.67,821
CZ042,568350,Velké Březno,692,697,1389,99.43,76.51,1826
CZ042,568384,Zubrnice,67,91,158,99.37,82.38,193
CZ041,538795,Krásná,153,188,341,99.42,69.01,497
CZ041,538817,Podhradí,42,67,109,97.32,66.67,168
CZ041,538868,Pomezí nad Ohří,113,98,211,99.06,78.89,270
CZ041,538906,Milíkov,79,85,164,100.00,71.30,230
CZ041,538922,Okrouhlá,76,77,153,100.00,75.86,203
CZ041,539023,Třebeň,103,157,260,100.00,74.07,351
CZ041,539074,Vojtanov,43,74,117,98.32,59.50,200
CZ041,539112,Stará Voda,113,144,257,100.00,63.77,403
CZ041,539279,Velká Hleďsebe,678,521,1199,99.83,67.74,1776
CZ041,539376,Vlkovice,37,36,73,100.00,66.36,110
CZ041,539431,Zádub-Závišín,101,91,192,99.48,70.96,272
CZ041,539473,Ovesné Kladruby,50,22,72,100.00,67.92,106
CZ041,539481,Valy,143,124,267,98.16,74.52,365
CZ041,539538,Prameny,23,41,64,100.00,74.42,86
CZ041,539554,Odrava,59,72,131,100.00,71.98,182
CZ041,539619,Tuřany,38,46,84,98.82,70.83,120
CZ041,554481,Cheb,6845,6949,13794,99.62,60.34,22967
CZ041,554499,Aš,2414,2771,5185,99.69,55.34,9403
CZ041,554502,Dolní Žandov,213,375,588,99.83,64.48,915
CZ041,554511,Drmoul,328,277,605,99.67,77.62,782
CZ041,554529,Františkovy Lázně,1820,1379,3199,99.66,69.82,4599
CZ041,554545,Hazlov,304,452,756,99.21,63.39,1202
CZ041,554553,Hranice,358,551,909,99.78,56.51,1612
CZ041,554596,Křižovatka,54,107,161,99.38,76.06,213
CZ041,554600,Lázně Kynžvart,313,403,716,99.31,61.84,1166
CZ041,554618,Libá,189,199,388,99.49,63.52,614
CZ041,554626,Lipová,203,211,414,100.00,68.89,601
CZ041,554634,Luby,408,615,1023,99.61,59.71,1720
CZ041,554642,Mariánské Lázně,3496,2656,6152,99.58,61.48,10084
CZ041,554651,Milhostov,9,126,135,99.26,55.28,246
CZ041,554677,Mnichov,81,105,186,99.47,56.97,330
CZ041,554693,Nebanice,83,126,209,99.52,77.21,272
CZ041,554707,Nový Kostel,88,159,247,99.60,57.94,428
CZ041,554740,Plesná,364,553,917,100.00,60.65,1512
CZ041,554812,Skalná,453,585,1038,99.52,69.91,1492
CZ041,554855,Trstěnice,62,123,185,94.87,65.66,297
CZ041,554880,Tři Sekery,273,243,516,99.42,63.37,819
CZ041,555631,Teplá,455,843,1298,99.85,58.40,2226
CZ041,577979,Poustka,46,38,84,100.00,61.31,137
CZ041,578002,Velký Luh,35,55,90,100.00,64.29,140
CZ041,500101,Bražec,22,86,108,99.08,63.37,172
CZ041,500127,Doupovské Hradiště,43,35,78,100.00,60.00,130
CZ041,506486,Boží Dar,474,58,532,99.44,91.61,584
CZ041,506494,Nové Hamry,141,120,261,96.67,82.82,326
CZ041,506621,Čichalov,15,60,75,100.00,60.98,123
CZ041,537845,Teplička,33,42,75,100.00,77.32,97
CZ041,537870,Březová,177,132,309,100.00,65.88,469
CZ041,537918,Dalovice,648,421,1069,99.63,69.83,1538
CZ041,537926,Jenišov,382,186,568,98.78,77.08,746
CZ041,537934,Mírová,121,84,205,100.00,76.49,268
CZ041,537969,Otovice,365,214,579,98.97,79.30,739
CZ041,538001,Andělská Hora,135,90,225,98.68,73.79,309
CZ041,538019,Černava,77,108,185,100.00,70.34,263
CZ041,538027,Smolné Pece,79,42,121,98.37,70.69,174
CZ041,538116,Děpoltovice,147,93,240,99.59,69.45,347
CZ041,538159,Hájek,222,156,378,99.21,77.60,491
CZ041,551651,Hory,162,62,224,99.12,75.08,301
CZ041,554961,Karlovy Vary,12717,9627,22344,99.44,63.41,35444
CZ041,554979,Abertamy,371,218,589,100.00,66.40,887
CZ041,554995,Bečov nad Teplou,226,282,508,99.22,67.37,760
CZ041,555029,Bochov,409,556,965,100.00,63.49,1520
CZ041,555045,Božičany,105,196,301,100.00,63.64,473
CZ041,555169,Horní Blatná,207,80,287,99.65,72.91,395
CZ041,555185,Hroznětín,535,506,1041,99.52,63.70,1642
CZ041,555207,Chyše,105,226,331,98.51,71.04,473
CZ041,555215,Jáchymov,763,653,1416,99.72,61.58,2306
CZ041,555258,Kolová,308,171,479,99.79,80.00,600
CZ041,555304,Krásné Údolí,76,131,207,100.00,65.09,318
CZ041,555347,Kyselka,201,210,411,100.00,64.12,641
CZ041,555363,Merklín,237,233,470,99.79,63.65,740
CZ041,555380,Nejdek,1781,1896,3677,99.46,60.89,6077
CZ041,555398,Nová Role,1157,1068,2225,99.78,66.81,3338
CZ041,555428,Ostrov,4141,4408,8549,99.56,64.30,13360
CZ041,555444,Otročín,90,138,228,99.56,63.61,360
CZ041,555452,Pernink,378,171,549,99.28,80.52,688
CZ041,555479,Potůčky,105,65,170,99.42,68.40,250
CZ041,555525,Pšov,90,192,282,100.00,59.75,472
CZ041,555533,Sadov,407,306,713,99.72,70.44,1015
CZ041,555550,Stanovice,168,152,320,100.00,63.87,501
CZ041,555584,Stráž nad Ohří,125,174,299,99.34,63.77,472
CZ041,555592,Stružná,157,165,322,99.69,67.29,480
CZ041,555614,Šemnice,202,141,343,100.00,63.52,540
CZ041,555622,Štědrá,116,149,265,99.62,59.64,446
CZ041,555657,Toužim,709,1051,1760,99.27,62.56,2834
CZ041,555681,Útvina,123,206,329,99.70,74.83,441
CZ041,555690,Valeč,96,102,198,99.50,68.86,289
CZ041,555703,Velichov,136,143,279,98.59,69.53,407
CZ041,555711,Verušičky,56,150,206,99.52,54.47,380
CZ041,555738,Vojkovice,140,193,333,99.11,68.29,492
CZ041,555762,Žlutice,460,694,1154,99.83,62.59,1847
CZ041,556947,Pila,165,162,327,99.70,73.54,446
CZ041,566675,Vrbice,23,69,92,98.92,62.00,150
CZ041,578011,Chodov,11,54,65,100.00,71.43,91
CZ041,578029,Vysoká Pec,113,85,198,100.00,80.16,247
CZ041,578045,Krásný Les,114,87,201,99.50,72.92,277
CZ041,511587,Josefov,110,117,227,100.00,70.72,321
CZ041,538337,Krásno,223,176,399,99.75,71.81,557
CZ041,538396,Šabina,117,108,225,100.00,76.79,293
CZ041,538434,Svatava,406,482,888,99.89,65.49,1359
CZ041,538591,Dolní Rychnov,378,345,723,99.86,65.28,1109
CZ041,538663,Tatrovice,38,64,102,99.03,74.64,138
CZ041,560286,Sokolov,4898,5640,10538,99.50,58.79,18020
CZ041,560294,Březová,624,711,1335,99.26,63.29,2125
CZ041,560308,Bublava,201,104,305,99.35,75.99,404
CZ041,560316,Bukovany,206,483,689,99.71,58.71,1177
CZ041,560324,Citice,190,244,434,99.54,61.50,709
CZ041,560332,Dasnice,54,74,128,100.00,58.99,217
CZ041,560341,Dolní Nivy,86,106,192,100.00,67.84,283
CZ041,560359,Habartov,844,1383,2227,99.15,58.98,3808
CZ041,560367,Horní Slavkov,1221,1691,2912,99.49,62.77,4676
CZ041,560375,Chlum Svaté Maří,94,89,183,99.46,73.31,251
CZ041,560383,Chodov,2538,3457,5995,99.63,58.36,10318
CZ041,560413,Jindřichovice,131,158,289,99.66,68.24,425
CZ041,560421,Kaceřov,109,130,239,100.00,66.76,358
CZ041,560456,Krajková,203,315,518,99.62,69.56,749
CZ041,560464,Královské Poříčí,186,254,440,100.00,71.57,619
CZ041,560472,Kraslice,1338,1658,2996,99.34,58.42,5163
CZ041,560499,Kynšperk nad Ohří,1043,1532,2575,99.77,63.07,4092
CZ041,560502,Libavské Údolí,86,199,285,98.96,64.86,444
CZ041,560537,Loket,1066,564,1630,99.69,66.79,2448
CZ041,560545,Lomnice,363,385,748,99.60,70.45,1066
CZ041,560561,Nová Ves,23,58,81,98.78,47.67,172
CZ041,560570,Nové Sedlo,457,784,1241,99.68,60.44,2060
CZ041,560588,Oloví,243,448,691,100.00,52.91,1306
CZ041,560596,Přebuz,37,38,75,100.00,82.42,91
CZ041,560600,Rotava,370,840,1210,99.75,52.33,2322
CZ041,560618,Rovná,29,92,121,99.18,48.03,254
CZ041,560642,Staré Sedlo,207,281,488,99.59,73.46,667
CZ041,560651,Stříbrná,128,126,254,98.83,71.19,361
CZ041,560677,Šindelová,70,105,175,99.43,65.19,270
CZ041,560685,Vintířov,162,384,546,99.64,59.69,918
CZ041,560707,Vřesová,11,151,162,100.00,50.78,319
CZ041,579360,Těšovice,81,89,170,99.42,81.43,210
CZ032,553425,Domažlice,2969,2491,5460,99.11,67.81,8127
CZ032,553433,Babylon,106,87,193,98.97,77.69,251
CZ032,553441,Bělá nad Radbuzou,360,481,841,100.00,62.11,1354
CZ032,553450,Blížejov,350,406,756,99.47,63.49,1197
CZ032,553514,Čermná,67,81,148,100.00,69.81,212
CZ032,553549,Česká Kubice,213,186,399,100.00,67.28,593
CZ032,553557,Díly,115,113,228,100.00,74.51,306
CZ032,553573,Drahotín,38,39,77,100.00,50.33,153
CZ032,553581,Draženov,116,92,208,100.00,66.67,312
CZ032,553620,Hlohová,76,67,143,98.62,66.82,217
CZ032,553671,Horšovský Týn,1186,1273,2459,99.64,65.80,3751
CZ032,553689,Hostouň,229,352,581,100.00,61.55,944
CZ032,553727,Chocomyšl,24,39,63,100.00,68.48,92
CZ032,553735,Chodov,202,231,433,98.41,70.97,620
CZ032,553743,Chodská Lhota,146,97,243,100.00,74.31,327
CZ032,553751,Chrastavice,156,77,233,99.57,81.25,288
CZ032,553778,Kaničky,12,14,26,100.00,100.00,26
CZ032,553786,Kdyně,1374,1233,2607,99.35,67.96,3861
CZ032,553794,Klenčí pod Čerchovem,423,279,702,99.01,68.77,1031
CZ032,553816,Koloveč,224,333,557,99.82,68.59,815
CZ032,553824,Kout na Šumavě,344,310,654,99.09,74.75,883
CZ032,553832,Křenovy,31,43,74,100.00,64.91,114
CZ032,553859,Libkov,38,39,77,100.00,78.57,98
CZ032,553867,Loučim,49,25,74,97.37,76.00,100
CZ032,553891,Luženičky,145,120,265,98.51,83.54,322
CZ032,553913,Meclov,275,342,617,99.20,69.22,900
CZ032,553921,Mezholezy,28,38,66,97.06,74.73,91
CZ032,553930,Mezholezy,30,40,70,100.00,70.00,100
CZ032,553948,Milavče,187,156,343,99.71,75.11,458
CZ032,553956,Mířkov,33,96,129,97.73,57.64,229
CZ032,553981,Mrákov,347,291,638,99.38,75.18,854
CZ032,553999,Mutěnín,63,80,143,100.00,68.10,210
CZ032,554006,Nemanice,36,67,103,100.00,48.58,212
CZ032,554031,Nevolice,84,37,121,100.00,77.07,157
CZ032,554057,Nový Kramolín,36,81,117,100.00,66.86,175
CZ032,554073,Osvračín,157,202,359,99.45,69.16,522
CZ032,554081,Pasečnice,56,49,105,100.00,69.08,152
CZ032,554090,Pec,72,59,131,100.00,70.43,186
CZ032,554111,Poběžovice,354,385,739,99.33,61.44,1211
CZ032,554120,Pocinovice,216,134,350,99.72,73.58,477
CZ032,554138,Postřekov,377,263,640,99.53,72.25,890
CZ032,554154,Puclice,69,125,194,100.00,71.85,270
CZ032,554189,Rybník,34,44,78,100.00,56.12,139
CZ032,554201,Semněvice,22,55,77,100.00,45.83,168
CZ032,554251,Spáňov,78,56,134,97.10,86.25,160
CZ032,554260,Srbice,96,137,233,98.31,74.29,319
CZ032,554278,Srby,87,164,251,99.60,68.38,370
CZ032,554294,Staňkov,832,960,1792,99.39,70.10,2575
CZ032,554316,Stráž,100,45,145,100.00,80.56,180
CZ032,554341,Tlumačov,154,91,245,100.00,71.85,341
CZ032,554359,Trhanov,155,146,301,99.01,71.19,427
CZ032,554383,Újezd,161,103,264,99.62,75.50,351
CZ032,554391,Únějovice,28,36,64,98.46,72.22,90
CZ032,554405,Úsilov,40,41,81,97.59,76.85,108
CZ032,554413,Velký Malahov,47,67,114,100.00,60.32,189
CZ032,554421,Vidice,31,67,98,98.99,72.26,137
CZ032,554448,Všepadly,16,19,35,100.00,83.33,42
CZ032,554456,Všeruby,158,208,366,99.46,56.44,652
CZ032,554464,Zahořany,334,263,597,99.67,74.41,805
CZ032,554472,Ždánov,54,35,89,100.00,75.42,118
CZ032,566136,Brnířov,142,78,220,100.00,67.90,324
CZ032,566144,Kanice,71,45,116,99.15,79.05,148
CZ032,566161,Úboč,33,42,75,98.68,69.09,110
CZ032,566179,Hradiště,64,31,95,98.96,69.06,139
CZ032,566209,Otov,19,33,52,98.11,61.63,86
CZ032,566250,Vlkanov,24,36,60,100.00,65.93,91
CZ032,566276,Hora Svatého Václava,43,12,55,100.00,82.09,67
CZ032,566292,Mnichov,39,67,106,100.00,60.57,175
CZ032,566331,Hvožďany,11,11,22,100.00,70.97,31
CZ032,566365,Poděvousy,49,83,132,100.00,70.59,187
CZ032,566373,Pelechy,34,21,55,100.00,83.33,66
CZ032,566641,Hlohovčice,45,65,110,99.10,72.08,154
CZ032,599131,Nová Ves,36,43,79,100.00,79.00,100
CZ032,599166,Němčice,45,42,87,100.00,76.99,113
CZ032,599174,Močerady,14,17,31,100.00,65.96,47
CZ032,599182,Pařezov,54,43,97,97.00,68.49,146
CZ032,530085,Bukovník,16,29,45,97.83,79.31,58
CZ032,530123,Dobršín,39,38,77,100.00,81.05,95
CZ032,541745,Myslovice,37,50,87,100.00,85.29,102
CZ032,541753,Ježovy,53,63,116,99.15,67.24,174
CZ032,541788,Poleň,61,109,170,100.00,73.28,232
CZ032,541796,Hejná,35,54,89,98.89,72.58,124
CZ032,541826,Kejnice,43,28,71,100.00,82.56,86
CZ032,541842,Běhařov,65,27,92,98.92,66.43,140
CZ032,541851,Klenová,36,25,61,100.00,75.31,81
CZ032,541869,Javor,28,20,48,97.96,79.03,62
CZ032,541885,Týnec,71,116,187,99.47,65.05,289
CZ032,541915,Obytce,59,68,127,100.00,75.15,169
CZ032,541923,Břežany,44,66,110,99.10,68.10,163
CZ032,541931,Kvášňovice,55,27,82,100.00,70.69,116
CZ032,541958,Olšany,59,70,129,100.00,77.25,167
CZ032,542024,Číhaň,63,52,115,97.46,69.82,169
CZ032,542059,Mlýnské Struhadlo,13,13,26,100.00,59.09,44
CZ032,542083,Hnačov,29,40,69,100.00,80.23,86
CZ032,542091,Horská Kvilda,179,20,199,98.03,96.67,210
CZ032,542148,Modrava,348,47,395,100.00,96.11,411
CZ032,542172,Červené Poříčí,69,64,133,99.25,68.72,195
CZ032,551686,Podmokly,39,54,93,100.00,83.78,111
CZ032,553522,Tužice,24,32,56,100.00,80.00,70
CZ032,553531,Černíkov,72,103,175,99.43,63.54,277
CZ032,555771,Klatovy,6300,5577,11877,99.39,70.13,17048
CZ032,555797,Běšiny,226,239,465,99.79,72.14,646
CZ032,555801,Bezděkov,278,243,521,99.62,71.25,734
CZ032,555835,Bolešiny,239,196,435,99.77,75.43,578
CZ032,555894,Budětice,65,95,160,97.56,69.49,236
CZ032,555941,Čachrov,184,137,321,99.69,68.08,473
CZ032,556041,Dešenice,174,219,393,100.00,70.30,559
CZ032,556068,Dlažov,112,119,231,99.57,62.37,372
CZ032,556076,Dlouhá Ves,274,243,517,99.81,75.95,682
CZ032,556084,Prášily,147,30,177,98.88,86.06,208
CZ032,556106,Dolany,260,264,524,99.62,71.76,733
CZ032,556181,Hartmanice,264,281,545,99.82,68.51,797
CZ032,556203,Hlavňovice,181,129,310,98.41,82.46,382
CZ032,556254,Horažďovice,1624,1376,3000,99.77,72.97,4121
CZ032,556301,Hrádek,426,349,775,99.23,70.87,1102
CZ032,556319,Hradešice,145,94,239,99.17,70.26,343
CZ032,556335,Chanovice,202,209,411,99.04,75.59,549
CZ032,556343,Chlistov,36,42,78,96.30,68.64,118
CZ032,556378,Chudenice,182,243,425,99.53,71.17,600
CZ032,556386,Chudenín,162,174,336,99.41,70.42,480
CZ032,556394,Janovice nad Úhlavou,644,601,1245,99.68,68.94,1816
CZ032,556432,Kašperské Hory,491,393,884,99.77,66.12,1340
CZ032,556467,Kolinec,399,422,821,99.64,70.67,1166
CZ032,556505,Křenice,54,66,120,100.00,73.17,164
CZ032,556629,Malý Bor,175,136,311,99.36,73.65,425
CZ032,556637,Měčín,245,414,659,99.55,73.23,904
CZ032,556718,Mochtín,319,321,640,99.69,72.54,885
CZ032,556726,Mokrosuky,56,32,88,100.00,80.00,110
CZ032,556734,Myslív,120,133,253,99.61,70.75,359
CZ032,556751,Nalžovské Hory,301,329,630,99.68,66.95,944
CZ032,556815,Nezdice na Šumavě,95,126,221,99.10,73.60,303
CZ032,556831,Nýrsko,1347,1210,2557,99.49,68.86,3732
CZ032,556912,Pačejov,199,195,394,99.24,66.95,593
CZ032,556921,Petrovice u Sušice,222,144,366,99.73,71.82,511
CZ032,556955,Plánice,470,523,993,99.80,73.94,1347
CZ032,557005,Předslav,225,251,476,99.37,74.49,643
CZ032,557013,Rabí,131,146,277,99.64,71.47,389
CZ032,557021,Rejštejn,91,61,152,100.00,67.56,225
CZ032,557099,Soběšice,98,152,250,99.60,77.95,322
CZ032,557111,Srní,262,62,324,100.00,81.20,399
CZ032,557129,Strašín,60,93,153,98.71,60.78,255
CZ032,557137,Strážov,375,374,749,99.47,72.04,1048
CZ032,557153,Sušice,3392,2590,5982,99.60,69.63,8629
CZ032,557161,Svéradice,94,106,200,100.00,75.19,266
CZ032,557200,Švihov,511,482,993,99.20,75.72,1322
CZ032,557366,Velhartice,279,205,484,99.79,71.11,682
CZ032,557374,Velké Hydčice,70,75,145,99.32,72.28,202
CZ032,557382,Velký Bor,139,171,310,99.68,71.49,435
CZ032,557455,Vrhaveč,331,258,589,99.83,81.49,724
CZ032,557463,Zavlekov,138,140,278,100.00,73.94,376
CZ032,557528,Železná Ruda,1244,387,1631,99.82,81.70,2000
CZ032,557536,Žihobce,158,191,349,99.43,73.43,478
CZ032,557544,Žichovice,159,214,373,99.47,72.82,515
CZ032,566055,Vřeskovice,136,54,190,100.00,73.93,257
CZ032,566683,Dražovice,39,55,94,100.00,74.02,127
CZ032,578061,Ostřetice,24,22,46,100.00,90.20,51
CZ032,578070,Lomec,30,37,67,100.00,65.69,102
CZ032,578088,Biřkov,32,34,66,100.00,68.04,97
CZ032,578177,Kovčín,18,26,44,97.78,65.22,69
CZ032,578223,Nehodiv,22,23,45,100.00,72.58,62
CZ032,578240,Hamry,32,35,67,100.00,60.36,111
CZ032,578312,Zborovy,35,31,66,98.51,67.00,100
CZ032,578321,Újezd u Plánice,37,39,76,100.00,74.51,102
CZ032,578410,Maňovice,13,19,32,100.00,72.73,44
CZ032,578436,Slatina,32,49,81,100.00,92.05,88
CZ032,578461,Mezihoří,31,13,44,95.65,80.70,57
CZ032,578495,Čímice,33,65,98,100.00,74.24,132
CZ032,578517,Domoraz,17,30,47,100.00,85.45,55
CZ032,578525,Frymburk,38,37,75,100.00,83.33,90
CZ032,578533,Nezamyslice,34,99,133,99.25,70.10,194
CZ032,539741,Štěnovický Borek,242,125,367,99.46,78.18,472
CZ032,540561,Letkov,391,134,525,99.43,84.75,623
CZ032,540641,Mokrouše,126,54,180,99.45,81.17,223
CZ032,553590,Nezbavětice,94,74,168,98.82,82.93,205
CZ032,545970,Plzeň 1,15556,10064,25620,99.62,68.76,37434
CZ032,545988,Plzeň 2-Slovany,11742,5738,17480,99.50,69.62,25244
CZ032,546003,Plzeň 3,15158,8961,24119,99.56,65.17,37204
CZ032,546208,Plzeň 4,8189,4647,12836,99.58,70.32,18347
CZ032,554731,Plzeň 5-Křimice,802,421,1223,99.59,72.49,1694
CZ032,554758,Plzeň 6-Litice,797,384,1181,99.33,72.65,1638
CZ032,554766,Plzeň 7-Radčice,400,249,649,99.85,77.50,840
CZ032,554774,Plzeň 8-Černice,777,285,1062,99.44,78.83,1356
CZ032,557978,Plzeň 10-Lhota,769,280,1049,99.53,78.89,1336
CZ032,559199,Plzeň 9-Malesice,340,173,513,99.81,74.06,694
CZ032,554791,Plzeň,54530,31202,85732,99.57,68.50,125787
CZ032,557846,Chválenice,298,142,440,99.32,77.72,570
CZ032,558001,Losiná,521,312,833,99.76,78.28,1068
CZ032,558141,Nezvěstice,470,368,838,99.76,74.60,1126
CZ032,558371,Starý Plzenec,2018,1036,3054,99.58,74.71,4105
CZ032,558427,Šťáhlavy,1027,612,1639,99.76,74.59,2204
CZ032,558460,Tymákov,383,234,617,99.68,79.56,778
CZ032,558851,Dýšina,663,350,1013,99.61,75.11,1354
CZ032,558966,Chrást,653,401,1054,99.72,73.30,1442
CZ032,559130,Kyšice,411,214,625,99.52,78.21,803
CZ032,578606,Lhůta,75,59,134,99.26,86.54,156
CZ032,530131,Přestavlky,64,62,126,100.00,70.79,178
CZ032,530140,Milínov,71,68,139,100.00,76.80,181
CZ032,530182,Žákava,149,99,248,99.60,66.22,376
CZ032,539716,Měcholupy,77,58,135,100.00,77.59,174
CZ032,539783,Oplot,107,105,212,99.53,78.31,272
CZ032,539821,Horní Lukavice,147,112,259,99.23,75.43,346
CZ032,539929,Týniště,15,18,33,100.00,78.57,42
CZ032,539937,Skašov,47,71,118,100.00,64.84,182
CZ032,539945,Dolce,65,94,159,100.00,69.43,229
CZ032,540056,Střelice,36,45,81,100.00,69.83,116
CZ032,540064,Lisov,31,40,71,98.61,66.67,108
CZ032,540102,Nezdřev,29,29,58,98.31,66.29,89
CZ032,540137,Životice,21,22,43,100.00,82.69,52
CZ032,540200,Kozlovice,21,40,61,100.00,71.76,85
CZ032,540251,Drahkov,34,58,92,98.92,78.15,119
CZ032,540269,Nová Ves,100,76,176,98.88,77.06,231
CZ032,540293,Otěšice,41,53,94,100.00,69.63,135
CZ032,540307,Chlumy,19,39,58,100.00,73.42,79
CZ032,540340,Nebílovy,114,109,223,99.55,78.20,289
CZ032,540412,Předenice,112,47,159,99.38,75.12,213
CZ032,540421,Radkovice,31,31,62,98.41,73.26,86
CZ032,540463,Bolkov,10,21,31,100.00,64.58,48
CZ032,540528,Únětice,52,42,94,100.00,76.42,123
CZ032,540617,Líšina,37,44,81,100.00,64.29,126
CZ032,540633,Kotovice,87,69,156,100.00,66.67,234
CZ032,540668,Honezovice,58,103,161,99.38,74.65,217
CZ032,540676,Srby,50,57,107,100.00,72.30,148
CZ032,540692,Sedliště,28,48,76,100.00,77.55,98
CZ032,540706,Vlčtejn,22,28,50,98.04,70.83,72
CZ032,542156,Borovy,87,51,138,100.00,74.19,186
CZ032,542296,Nezdice,62,64,126,100.00,70.39,179
CZ032,546372,Buková,71,70,141,99.30,71.72,198
CZ032,546399,Míšov,39,40,79,97.53,83.51,97
CZ032,553506,Bukovec,18,41,59,100.00,67.05,88
CZ032,553565,Polánka,16,13,29,100.00,78.38,37
CZ032,553654,Holýšov,1247,1292,2539,99.41,66.80,3825
CZ032,553662,Horní Kamenice,72,64,136,100.00,73.12,186
CZ032,553841,Kvíčovice,114,117,231,100.00,69.58,332
CZ032,554022,Neuměř,50,42,92,100.00,74.80,123
CZ032,557587,Blovice,1322,1003,2325,99.66,72.44,3222
CZ032,557641,Čižice,220,138,358,99.17,80.04,451
CZ032,557650,Čížkov,193,184,377,98.95,70.69,539
CZ032,557668,Dnešice,219,226,445,99.78,69.47,642
CZ032,557676,Dobřany,1902,1569,3471,99.63,69.30,5033
CZ032,557684,Dolní Lukavice,287,261,548,99.28,66.91,825
CZ032,557722,Horšice,83,160,243,99.59,69.52,351
CZ032,557731,Hradec,186,164,350,99.15,76.24,463
CZ032,557749,Hradiště,84,52,136,100.00,75.56,180
CZ032,557773,Chlum,65,82,147,100.00,80.33,183
CZ032,557781,Chlumčany,612,552,1164,99.74,64.23,1817
CZ032,557803,Chocenice,157,187,344,100.00,74.78,460
CZ032,557838,Chotěšov,775,690,1465,99.86,67.79,2164
CZ032,557862,Kasejovice,349,311,660,99.85,69.29,954
CZ032,557871,Kbel,71,97,168,100.00,70.59,238
CZ032,557897,Klášter,74,48,122,98.39,68.13,182
CZ032,557943,Kramolín,50,30,80,98.77,82.65,98
CZ032,557951,Letiny,189,200,389,98.98,65.94,596
CZ032,558010,Louňová,23,45,68,100.00,79.07,86
CZ032,558028,Lužany,234,159,393,100.00,71.98,546
CZ032,558044,Merklín,294,312,606,99.51,67.59,901
CZ032,558052,Mileč,99,112,211,99.06,73.96,288
CZ032,558061,Mladý Smolivec,180,215,395,99.00,71.51,558
CZ032,558079,Mohelnice,24,17,41,100.00,71.93,57
CZ032,558095,Nekvasovy,39,65,104,100.00,67.53,154
CZ032,558109,Nepomuk,1032,852,1884,99.63,68.27,2770
CZ032,558117,Netunice,63,50,113,100.00,71.97,157
CZ032,558125,Neurazy,198,212,410,100.00,67.55,607
CZ032,558176,Nové Mitrovice,109,106,215,98.17,77.11,284
CZ032,558184,Oselce,85,106,191,100.00,64.97,294
CZ032,558231,Prádlo,73,57,130,100.00,71.82,181
CZ032,558249,Přeštice,1901,1710,3611,99.34,69.75,5213
CZ032,558257,Příchovice,424,283,707,99.86,76.71,923
CZ032,558265,Ptenín,57,65,122,100.00,73.94,165
CZ032,558290,Roupov,89,80,169,98.83,75.00,228
CZ032,558303,Řenče,254,295,549,99.10,76.20,727
CZ032,558311,Seč,91,88,179,99.44,71.15,253
CZ032,558346,Soběkury,169,186,355,99.72,73.10,487
CZ032,558362,Spálené Poříčí,783,747,1530,99.67,69.16,2221
CZ032,558389,Stod,906,918,1824,99.45,65.15,2815
CZ032,558401,Střížovice,120,128,248,99.60,80.32,310
CZ032,558435,Štěnovice,784,419,1203,99.59,73.93,1634
CZ032,558486,Útušice,274,140,414,100.00,74.86,553
CZ032,558494,Ves Touškov,85,94,179,100.00,65.09,275
CZ032,558559,Vrčeň,117,63,180,99.45,68.82,263
CZ032,558567,Vstiš,169,156,325,98.78,73.93,445
CZ032,558583,Zdemyslice,206,177,383,100.00,77.37,495
CZ032,558591,Zemětice,99,109,208,100.00,79.39,262
CZ032,558605,Ždírec,131,160,291,99.66,75.84,385
CZ032,558630,Žinkovy,226,273,499,99.60,68.54,731
CZ032,566071,Všekary,46,23,69,98.57,81.40,86
CZ032,566080,Čečovice,10,28,38,100.00,57.58,66
CZ032,566098,Černovice,34,50,84,100.00,57.53,146
CZ032,566101,Štichov,20,39,59,100.00,88.06,67
CZ032,566691,Vlčí,21,26,47,100.00,79.66,59
CZ032,566705,Borovno,31,39,70,100.00,84.34,83
CZ032,578541,Jarov,56,93,149,100.00,77.60,192
CZ032,578568,Čmelíny,41,36,77,100.00,72.64,106
CZ032,578592,Třebčice,39,18,57,100.00,69.51,82
CZ032,578614,Tojice,30,38,68,98.55,79.55,88
CZ032,530221,Hněvnice,33,37,70,98.59,73.20,97
CZ032,530239,Bílov,20,19,39,100.00,65.00,60
CZ032,530247,Potvorov,44,38,82,100.00,77.36,106
CZ032,530271,Sedlec,14,28,42,100.00,52.50,80
CZ032,530280,Vysoká Libyně,62,87,149,100.00,78.42,190
CZ032,530328,Čerňovice,47,57,104,100.00,62.28,167
CZ032,530336,Pláně,90,71,161,99.38,73.30,221
CZ032,538183,Kbelany,33,39,72,98.63,70.87,103
CZ032,546411,Úherce,105,100,205,100.00,66.78,307
CZ032,553603,Studená,23,10,33,97.06,91.89,37
CZ032,558656,Bezvěrov,102,232,334,100.00,62.20,537
CZ032,558672,Blatnice,262,246,508,99.41,77.31,661
CZ032,558699,Bučí,84,29,113,100.00,80.71,140
CZ032,558711,Čeminy,88,81,169,98.83,72.77,235
CZ032,558745,Česká Bříza,239,133,372,99.20,79.62,471
CZ032,558770,Dobříč,142,115,257,100.00,76.04,338
CZ032,558788,Dolany,109,54,163,98.79,72.37,228
CZ032,558796,Dolní Bělá,153,125,278,100.00,74.13,375
CZ032,558800,Dolní Hradiště,31,15,46,100.00,82.14,56
CZ032,558834,Druztová,303,151,454,99.13,73.28,625
CZ032,558869,Heřmanova Huť,410,493,903,99.78,61.94,1461
CZ032,558877,Horní Bělá,203,179,382,99.74,79.13,484
CZ032,558885,Horní Bříza,1201,985,2186,99.36,66.45,3311
CZ032,558915,Hromnice,474,304,778,99.23,75.60,1037
CZ032,558931,Hvozd,79,92,171,99.42,83.09,207
CZ032,558940,Chotíkov,479,276,755,99.60,75.95,998
CZ032,558974,Chříč,68,54,122,100.00,58.65,208
CZ032,558982,Jarov,48,31,79,97.53,69.23,117
CZ032,558991,Kaceřov,61,35,96,100.00,76.19,126
CZ032,559008,Kaznějov,869,776,1645,99.64,69.66,2370
CZ032,559024,Kopidlo,45,37,82,100.00,72.57,113
CZ032,559032,Koryta,57,22,79,100.00,76.70,103
CZ032,559041,Kozojedy,204,160,364,99.73,72.85,501
CZ032,559059,Kozolupy,323,242,565,99.47,70.38,807
CZ032,559067,Kožlany,430,360,790,100.00,70.50,1122
CZ032,559075,Kralovice,1041,902,1943,99.59,70.52,2768
CZ032,559083,Krašovice,112,112,224,100.00,73.68,304
CZ032,559091,Krsy,67,96,163,100.00,71.18,229
CZ032,559105,Křelovice,42,70,112,96.55,60.10,193
CZ032,559121,Kunějovice,39,44,83,100.00,55.70,149
CZ032,559148,Ledce,303,221,524,99.43,78.17,678
CZ032,559164,Líně,791,694,1485,99.33,71.06,2104
CZ032,559172,Líšťany,200,187,387,99.49,65.49,594
CZ032,559202,Manětín,348,332,680,100.00,71.20,955
CZ032,559211,Město Touškov,774,485,1259,99.76,72.16,1749
CZ032,559237,Mladotice,157,180,337,99.41,73.86,459
CZ032,559245,Mrtník,124,100,224,99.12,83.70,270
CZ032,559253,Nadryby,56,21,77,98.72,70.27,111
CZ032,559261,Nečtiny,142,215,357,100.00,66.98,533
CZ032,559270,Nekmíř,169,156,325,99.09,76.46,429
CZ032,559288,Nevřeň,109,54,163,99.39,67.49,243
CZ032,559300,Nýřany,1900,1627,3527,99.49,66.37,5341
CZ032,559318,Obora,211,134,345,99.42,75.76,458
CZ032,559326,Ostrov u Bezdružic,29,75,104,100.00,65.41,159
CZ032,559334,Pernarec,168,223,391,100.00,66.38,589
CZ032,559351,Plasy,874,668,1542,99.55,70.38,2201
CZ032,559369,Plešnice,89,63,152,100.00,68.16,223
CZ032,559377,Pňovany,113,157,270,100.00,72.39,373
CZ032,559393,Přehýšov,146,167,313,99.68,66.81,470
CZ032,559423,Rochlov,74,76,150,100.00,64.38,233
CZ032,559431,Rybnice,199,162,361,100.00,77.14,468
CZ032,559482,Tis u Blatna,24,43,67,100.00,83.75,80
CZ032,559491,Tlučná,1125,662,1787,99.55,70.90,2533
CZ032,559504,Trnová,314,254,568,99.82,73.23,777
CZ032,559521,Třemošná,1845,940,2785,99.68,71.50,3909
CZ032,559555,Úlice,128,120,248,97.64,68.10,373
CZ032,559563,Úněšov,150,198,348,100.00,67.44,516
CZ032,559571,Úterý,107,133,240,100.00,63.49,378
CZ032,559580,Vejprnice,1666,850,2516,99.72,76.97,3278
CZ032,559601,Vochov,540,250,790,99.50,75.84,1047
CZ032,559628,Všeruby,485,386,871,99.43,71.69,1222
CZ032,559661,Zbůch,695,640,1335,99.63,69.21,1936
CZ032,559679,Zruč-Senec,1302,684,1986,99.25,77.02,2598
CZ032,559695,Žihle,331,398,729,99.45,67.68,1083
CZ032,559709,Žilov,186,91,277,99.64,77.01,361
CZ032,566390,Hlince,27,25,52,98.11,76.81,69
CZ032,566420,Líté,58,61,119,99.17,65.57,183
CZ032,566446,Loza,84,87,171,100.00,80.28,213
CZ032,566462,Lochousice,37,32,69,100.00,66.99,103
CZ032,566471,Bohy,49,25,74,100.00,78.72,94
CZ032,566489,Brodeslavy,18,34,52,100.00,80.00,65
CZ032,566497,Všehrdy,16,21,37,100.00,71.15,52
CZ032,566543,Myslinka,100,42,142,100.00,69.61,204
CZ032,566594,Újezd nade Mží,21,44,65,100.00,78.31,83
CZ032,566632,Černíkovice,32,26,58,100.00,81.69,71
CZ032,566730,Holovousy,22,10,32,100.00,76.19,42
CZ032,566748,Slatina,18,27,45,95.74,88.68,53
CZ032,566756,Bdeněves,293,166,459,99.78,79.04,582
CZ032,566764,Blažim,8,24,32,100.00,59.26,54
CZ032,566781,Pastuchovice,27,28,55,100.00,84.62,65
CZ032,566969,Výrov,131,130,261,99.24,72.05,365
CZ032,567086,Příšov,132,72,204,99.03,74.64,276
CZ032,578665,Dražeň,61,35,96,100.00,77.42,124
CZ032,578771,Kočín,43,22,65,100.00,66.33,98
CZ032,578797,Štichovice,58,29,87,100.00,82.08,106
CZ032,578827,Zahrádka,29,47,76,100.00,64.41,118
CZ032,578924,Velečín,21,32,53,98.15,80.60,67
CZ032,578983,Tatiná,85,77,162,99.39,77.62,210
CZ032,506664,Skořice,57,118,175,98.87,75.97,233
CZ032,530361,Kařízek,25,8,33,100.00,76.74,43
CZ032,530379,Drahoňův Újezd,49,42,91,100.00,84.26,108
CZ032,540722,Smědčice,149,65,214,98.62,91.18,238
CZ032,540803,Chlum,25,9,34,100.00,82.93,41
CZ032,540927,Čilá,22,4,26,100.00,96.30,27
CZ032,541001,Hradiště,23,10,33,97.06,91.89,37
CZ032,541061,Zvíkovec,54,37,91,100.00,53.53,170
CZ032,541095,Bezděkov,40,39,79,98.75,68.97,116
CZ032,541141,Chomle,15,34,49,100.00,77.78,63
CZ032,541150,Kamenný Újezd,306,207,513,99.81,76.72,670
CZ032,541176,Svojkovice,129,160,289,100.00,77.27,374
CZ032,541192,Nevid,42,69,111,100.00,78.17,142
CZ032,546488,Sirá,57,40,97,100.00,75.19,129
CZ032,546526,Těškov,103,119,222,100.00,81.62,272
CZ032,546534,Týček,78,88,166,100.00,83.84,198
CZ032,546551,Újezd u Svatého Kříže,64,71,135,99.26,72.73,187
CZ032,553611,Litohlavy,181,136,317,100.00,72.71,436
CZ032,559717,Rokycany,3729,3297,7026,99.49,68.65,10295
CZ032,559725,Břasy,618,615,1233,99.44,70.91,1750
CZ032,559733,Březina,102,121,223,98.24,78.28,290
CZ032,559741,Bujesily,25,22,47,100.00,78.33,60
CZ032,559750,Bušovice,221,169,390,100.00,79.75,489
CZ032,559768,Cekov,70,29,99,99.00,71.94,139
CZ032,559776,Dobřív,359,397,756,98.95,73.25,1043
CZ032,559792,Ejpovice,271,164,435,99.54,76.27,573
CZ032,559806,Hlohovice,82,122,204,100.00,73.12,279
CZ032,559814,Holoubkov,384,421,805,99.88,70.70,1140
CZ032,559822,Hrádek,664,759,1423,99.51,66.54,2149
CZ032,559849,Hůrky,86,56,142,99.30,77.72,184
CZ032,559857,Cheznovice,188,227,415,100.00,70.27,592
CZ032,559903,Kařez,230,166,396,99.25,73.21,545
CZ032,559911,Klabava,175,121,296,99.33,75.25,396
CZ032,559920,Kladruby,42,55,97,98.98,67.59,145
CZ032,559946,Lhotka u Radnic,20,25,45,100.00,76.27,59
CZ032,559954,Liblín,46,85,131,99.24,68.04,194
CZ032,559962,Líšná,75,35,110,100.00,76.92,143
CZ032,559997,Mirošov,612,667,1279,99.69,71.28,1800
CZ032,560006,Mlečice,79,112,191,98.96,77.82,248
CZ032,560014,Mýto,504,376,880,99.66,71.51,1239
CZ032,560057,Osek,405,375,780,99.49,74.03,1059
CZ032,560081,Podmokly,64,87,151,100.00,74.75,202
CZ032,560111,Přívětice,65,67,132,100.00,76.30,173
CZ032,560120,Radnice,530,470,1000,99.60,71.46,1405
CZ032,560146,Sebečice,29,29,58,100.00,77.33,75
CZ032,560162,Strašice,672,637,1309,99.39,67.13,1962
CZ032,560189,Těně,87,91,178,100.00,73.55,242
CZ032,560227,Vejvanov,72,71,143,100.00,76.06,188
CZ032,560235,Veselá,99,71,170,100.00,74.24,229
CZ032,560251,Volduchy,417,279,696,99.29,76.95,911
CZ032,560260,Zbiroh,756,639,1395,99.71,70.16,1994
CZ032,566799,Všenice,93,79,172,96.63,79.82,223
CZ032,566802,Terešov,75,32,107,100.00,71.81,149
CZ032,566811,Kamenec,17,26,43,100.00,75.44,57
CZ032,566837,Němčovice,67,57,124,100.00,76.54,162
CZ032,566845,Skomelno,52,58,110,100.00,71.43,154
CZ032,566861,Plískov,61,25,86,98.85,86.14,101
CZ032,566942,Raková,84,51,135,99.26,73.91,184
CZ032,566993,Ostrovec-Lhotka,54,31,85,98.84,87.76,98
CZ032,567001,Lhota pod Radčem,83,94,177,99.44,73.55,242
CZ032,579009,Medový Újezd,84,72,156,96.89,75.59,213
CZ032,579017,Kakejcov,33,34,67,98.53,86.08,79
CZ032,579033,Kornatice,100,58,158,98.14,80.50,200
CZ032,579084,Mešno,23,35,58,100.00,75.32,77
CZ032,579131,Příkosice,129,115,244,99.19,77.36,318
CZ032,579246,Trokavec,40,36,76,98.70,82.80,93
CZ032,579289,Vísky,25,18,43,100.00,87.76,49
CZ032,579343,Štítov,11,24,35,100.00,79.55,44
CZ032,503916,Kostelec,108,178,286,100.00,64.85,441
CZ032,541290,Horní Kozolupy,44,92,136,100.00,68.34,199
CZ032,541362,Zadní Chodov,30,95,125,100.00,62.50,200
CZ032,541401,Broumov,42,40,82,100.00,78.85,104
CZ032,541435,Únehle,29,50,79,98.75,80.81,99
CZ032,541443,Obora,64,39,103,100.00,76.30,135
CZ032,541460,Zhoř,20,39,59,98.33,45.80,131
CZ032,541486,Prostiboř,39,27,66,100.00,55.00,120
CZ032,541494,Kokašice,52,81,133,100.00,67.17,198
CZ032,541532,Milíře,50,62,112,100.00,58.03,193
CZ032,541559,Kočov,38,52,90,100.00,56.60,159
CZ032,541605,Brod nad Tichou,32,119,151,99.34,75.62,201
CZ032,541621,Tisová,102,139,241,100.00,67.89,355
CZ032,541664,Záchlumí,51,155,206,100.00,63.78,323
CZ032,541681,Ošelín,20,55,75,100.00,59.06,127
CZ032,541702,Lom u Tachova,132,132,264,99.62,73.00,363
CZ032,557081,Sytno,52,84,136,100.00,62.67,217
CZ032,560715,Tachov,2835,3123,5958,99.60,66.77,8959
CZ032,560723,Benešovice,64,76,140,100.00,70.00,200
CZ032,560740,Bezdružice,195,284,479,100.00,67.94,705
CZ032,560758,Bor,749,1208,1957,99.80,65.48,2995
CZ032,560782,Cebiv,35,70,105,99.06,48.40,219
CZ032,560804,Částkov,87,128,215,100.00,82.06,262
CZ032,560812,Černošín,244,349,593,99.33,66.19,902
CZ032,560839,Dlouhý Újezd,104,97,201,97.57,70.31,293
CZ032,560855,Erpužice,72,130,202,99.02,69.39,294
CZ032,560863,Halže,232,288,520,100.00,70.56,737
CZ032,560898,Hošťka,66,125,191,99.48,60.00,320
CZ032,560901,Chodová Planá,336,603,939,99.68,66.71,1412
CZ032,560910,Chodský Újezd,148,287,435,100.00,69.82,623
CZ032,560928,Kladruby,445,466,911,99.78,71.78,1272
CZ032,560952,Konstantinovy Lázně,291,267,558,99.47,71.19,788
CZ032,560979,Kšice,37,83,120,100.00,70.59,170
CZ032,561002,Lesná,92,185,277,99.64,74.33,374
CZ032,561011,Lestkov,54,127,181,100.00,60.13,301
CZ032,561134,Planá,1130,1633,2763,99.68,67.21,4126
CZ032,561151,Přimda,223,370,593,99.50,64.09,930
CZ032,561169,Rozvadov,441,230,671,100.00,79.79,841
CZ032,561185,Staré Sedliště,218,322,540,100.00,60.20,897
CZ032,561193,Staré Sedlo,41,116,157,100.00,78.50,200
CZ032,561207,Stráž,258,390,648,99.85,67.60,960
CZ032,561215,Stříbro,1874,2017,3891,99.62,67.45,5791
CZ032,561223,Studánka,150,143,293,100.00,72.89,402
CZ032,561231,Sulislav,56,74,130,99.24,74.86,175
CZ032,561258,Svojšín,72,150,222,100.00,65.49,339
CZ032,561291,Trpísty,56,82,138,100.00,69.00,200
CZ032,561304,Třemešné,94,110,204,100.00,68.46,298
CZ032,566888,Olbramov,30,17,47,100.00,70.15,67
CZ032,579459,Ctiboř,78,116,194,100.00,78.23,248
CZ032,579467,Skapce,40,26,66,100.00,62.26,106
CZ032,579491,Vranov,52,65,117,99.15,71.52,165
CZ020,513431,Chýnice,201,49,250,99.60,79.50,317
CZ020,513458,Vestec,932,315,1247,99.84,78.85,1584
CZ020,531146,Drahelčice,533,158,691,99.57,78.86,880
CZ020,531618,Nučice,953,237,1190,99.00,76.67,1569
CZ020,531723,Rudná,2125,659,2784,99.54,77.32,3620
CZ020,531821,Tachlovice,367,145,512,99.22,72.11,717
CZ020,532215,Červený Újezd,645,249,894,99.44,81.36,1105
CZ020,532789,Ptice,442,131,573,99.83,81.65,703
CZ020,532991,Úhonice,457,220,677,99.85,76.44,887
CZ020,539104,Bojanovice,212,95,307,99.68,78.97,390
CZ020,539121,Černolice,271,49,320,100.00,81.42,393
CZ020,539139,Černošice,3575,776,4351,99.25,80.51,5448
CZ020,539147,Číčovice,125,51,176,99.44,74.37,238
CZ020,539155,Čisovice,486,188,674,99.41,76.61,885
CZ020,539163,Davle,753,260,1013,99.51,77.36,1316
CZ020,539171,Dobrovíz,209,131,340,99.13,80.14,428
CZ020,539180,Dobříč,148,54,202,99.51,81.85,248
CZ020,539198,Dobřichovice,1810,373,2183,99.27,80.52,2731
CZ020,539210,Dolní Břežany,1895,448,2343,99.49,78.28,3011
CZ020,539228,Holubice,784,264,1048,99.62,79.23,1329
CZ020,539236,Horoměřice,1872,570,2442,98.19,78.68,3162
CZ020,539244,Hostivice,3451,1088,4539,99.43,74.64,6120
CZ020,539252,Hradištko,1014,356,1370,99.42,78.22,1763
CZ020,539261,Hvozdnice,273,80,353,99.72,81.01,437
CZ020,539287,Choteč,142,65,207,100.00,73.14,283
CZ020,539295,Chrášťany,346,138,484,99.38,72.84,670
CZ020,539309,Chýně,1674,414,2088,99.52,82.11,2555
CZ020,539317,Jeneč,472,255,727,99.86,71.94,1012
CZ020,539325,Jesenice,3614,1100,4714,99.54,76.88,6160
CZ020,539333,Jílové u Prahy,1943,747,2690,99.67,72.89,3704
CZ020,539341,Jíloviště,300,92,392,98.99,73.06,542
CZ020,539350,Jinočany,863,258,1121,99.20,78.53,1439
CZ020,539368,Kamenný Přívoz,541,322,863,99.42,73.29,1187
CZ020,539384,Kněževes,225,125,350,99.72,79.64,442
CZ020,539392,Kosoř,363,152,515,99.61,76.40,678
CZ020,539406,Lety,727,149,876,98.98,81.64,1084
CZ020,539414,Libčice nad Vltavou,1336,522,1858,99.89,70.33,2646
CZ020,539422,Libeř,657,236,893,99.78,78.58,1139
CZ020,539457,Líšnice,335,107,442,99.55,75.77,586
CZ020,539490,Měchenice,358,151,509,100.00,76.89,662
CZ020,539503,Ohrobec,699,200,899,99.45,82.71,1093
CZ020,539511,Okrouhlo,332,121,453,99.56,78.04,583
CZ020,539520,Ořech,409,147,556,99.82,76.97,725
CZ020,539546,Petrov,316,146,462,98.93,76.81,608
CZ020,539562,Pohoří,186,61,247,100.00,80.46,307
CZ020,539571,Průhonice,1096,435,1531,99.42,80.42,1915
CZ020,539597,Psáry,1642,588,2230,99.46,73.43,3056
CZ020,539627,Roztoky,3754,966,4720,99.45,79.46,5973
CZ020,539643,Řevnice,1618,463,2081,99.38,77.60,2701
CZ020,539651,Řitka,613,183,796,99.75,79.25,1007
CZ020,539660,Slapy,449,139,588,99.49,74.09,799
CZ020,539686,Statenice,631,208,839,99.53,78.79,1070
CZ020,539708,Středokluky,422,211,633,99.22,77.62,822
CZ020,539732,Štěchovice,927,295,1222,99.11,72.89,1693
CZ020,539759,Třebotov,688,210,898,99.56,80.97,1114
CZ020,539767,Tuchoměřice,659,214,873,99.54,77.89,1126
CZ020,539775,Tursko,315,128,443,99.11,70.73,632
CZ020,539805,Únětice,388,70,458,100.00,82.08,558
CZ020,539813,Velké Přílepy,1326,441,1767,99.66,79.51,2230
CZ020,539830,Vonoklasy,271,63,334,99.40,76.54,439
CZ020,539848,Vrané nad Vltavou,1112,400,1512,99.67,75.53,2011
CZ020,539856,Všenory,770,242,1012,99.41,77.59,1312
CZ020,539872,Zbuzany,572,155,727,99.59,81.29,898
CZ020,539881,Zlatníky-Hodkovice,536,209,745,99.73,74.21,1008
CZ020,539902,Zvole,864,212,1076,99.54,80.97,1335
CZ020,540048,Buš,177,58,235,99.58,85.82,275
CZ020,540765,Mníšek pod Brdy,2434,838,3272,99.42,74.37,4425
CZ020,571199,Bratřínov,98,34,132,100.00,80.00,165
CZ020,571211,Klínec,362,91,453,99.34,75.00,608
CZ020,571261,Kytín,273,96,369,98.66,83.11,450
CZ020,571288,Zahořany,134,61,195,99.49,72.32,271
CZ020,571318,Roblín,116,31,147,99.32,77.49,191
CZ020,571326,Lichoceves,159,55,214,99.07,70.13,308
CZ020,571334,Okoř,51,7,58,100.00,75.32,77
CZ020,571342,Svrkyně,108,56,164,99.39,71.43,231
CZ020,571351,Úholičky,322,138,460,100.00,79.04,582
CZ020,598313,Trnová,213,56,269,99.26,80.00,340
CZ020,599727,Karlík,231,59,290,99.66,78.02,373
CZ020,599735,Březová-Oleško,579,190,769,99.61,76.21,1013
CZ020,513504,Dlouhá Lhota,160,100,260,99.62,78.14,334
CZ020,513512,Zduchovice,114,85,199,100.00,76.54,260
CZ020,513521,Lešetice,61,64,125,100.00,76.69,163
CZ020,513539,Velká Lečice,80,37,117,100.00,73.58,159
CZ020,513547,Příčovy,141,66,207,98.10,80.30,264
CZ020,513555,Kotenčice,77,52,129,99.23,76.47,170
CZ020,513571,Občov,77,52,129,99.23,81.76,159
CZ020,513580,Hudčice,85,53,138,99.28,72.77,191
CZ020,529664,Těchařovice,16,18,34,100.00,69.39,49
CZ020,529672,Bezděkov pod Třemšínem,54,41,95,100.00,77.87,122
CZ020,529681,Koupě,33,44,77,100.00,79.38,97
CZ020,530573,Sedlec-Prčice,1050,730,1780,99.50,74.48,2402
CZ020,539911,Příbram,9987,6808,16795,99.63,67.38,25026
CZ020,539953,Bohutín,594,448,1042,99.52,71.66,1461
CZ020,539970,Borotice,158,88,246,100.00,75.00,328
CZ020,539988,Bratkovice,127,78,205,100.00,78.54,261
CZ020,540013,Březnice,964,917,1881,99.68,67.89,2781
CZ020,540021,Buková u Příbramě,170,94,264,99.25,82.61,322
CZ020,540072,Čenkov,110,98,208,100.00,66.88,311
CZ020,540081,Čím,148,72,220,100.00,80.88,272
CZ020,540099,Daleké Dušníky,189,76,265,99.62,73.89,360
CZ020,540111,Dobříš,3337,1630,4967,99.70,73.73,6764
CZ020,540129,Dolní Hbity,335,275,610,99.51,81.52,752
CZ020,540145,Drahlín,160,176,336,100.00,74.83,449
CZ020,540153,Drásov,156,125,281,99.65,80.34,351
CZ020,540170,Drevníky,118,101,219,100.00,71.34,307
CZ020,540188,Drhovy,99,57,156,99.36,70.09,224
CZ020,540218,Dublovice,422,246,668,99.70,76.48,876
CZ020,540242,Hluboš,257,154,411,99.52,77.38,535
CZ020,540285,Hřiměždice,155,107,262,98.87,75.71,350
CZ020,540315,Hvožďany,255,239,494,100.00,76.35,647
CZ020,540323,Chotilsko,205,110,315,99.68,72.64,435
CZ020,540358,Chraštice,105,49,154,99.35,75.98,204
CZ020,540374,Jablonná,126,129,255,99.22,77.41,332
CZ020,540391,Jesenice,193,133,326,100.00,74.09,440
CZ020,540404,Jince,657,516,1173,98.99,65.91,1798
CZ020,540439,Kamýk nad Vltavou,321,211,532,99.44,72.89,734
CZ020,540447,Klučenice,179,103,282,99.30,73.01,389
CZ020,540498,Kosova Hora,471,306,777,99.49,72.31,1080
CZ020,540536,Kozárovice,109,129,238,99.17,74.07,324
CZ020,540552,Krásná Hora nad Vltavou,375,256,631,99.84,71.25,887
CZ020,540579,Křepenice,103,39,142,99.30,82.66,173
CZ020,540587,Křešín,52,50,102,99.03,84.43,122
CZ020,540625,Láz,225,144,369,99.73,76.60,483
CZ020,540714,Malá Hraštice,428,218,646,99.38,76.05,856
CZ020,540749,Milešov,119,85,204,98.55,70.41,294
CZ020,540757,Milín,744,510,1254,99.68,73.97,1702
CZ020,540781,Mokrovraty,294,158,452,99.12,76.51,596
CZ020,540790,Nalžovice,216,117,333,99.11,70.59,476
CZ020,540811,Nečín,258,184,442,99.10,71.94,620
CZ020,540820,Nedrahovice,183,94,277,99.28,75.41,370
CZ020,540846,Nechvalice,258,121,379,99.74,72.94,521
CZ020,540889,Nová Ves pod Pleší,677,231,908,99.56,84.76,1076
CZ020,540897,Nové Dvory,131,40,171,99.42,78.18,220
CZ020,540901,Nový Knín,709,456,1165,99.32,74.52,1574
CZ020,540935,Obecnice,413,313,726,99.73,72.01,1011
CZ020,540943,Obory,111,81,192,100.00,81.01,237
CZ020,540951,Obořiště,265,170,435,100.00,78.66,553
CZ020,540960,Ohrazenice,108,79,187,98.94,79.17,240
CZ020,541010,Ouběnice,121,37,158,100.00,86.34,183
CZ020,541028,Pečice,118,97,215,100.00,71.43,301
CZ020,541044,Petrovice,557,229,786,98.87,73.54,1081
CZ020,541052,Pičín,178,182,360,99.45,72.26,501
CZ020,541087,Počepice,203,128,331,98.81,73.63,455
CZ020,541133,Prosenická Lhota,196,104,300,100.00,72.64,413
CZ020,541206,Rosovice,272,206,478,100.00,67.94,705
CZ020,541231,Rožmitál pod Třemšínem,1289,1151,2440,99.51,71.30,3439
CZ020,541257,Rybníky,212,93,305,100.00,83.11,367
CZ020,541273,Sádek,65,76,141,100.00,72.68,194
CZ020,541281,Sedlčany,2602,1421,4023,99.63,71.47,5653
CZ020,541311,Smolotely,102,73,175,99.43,84.21,209
CZ020,541320,Solenice,97,99,196,100.00,63.64,308
CZ020,541338,Stará Huť,638,265,903,99.12,77.60,1174
CZ020,541371,Suchodol,158,89,247,99.60,82.39,301
CZ020,541389,Svaté Pole,219,97,316,98.75,81.22,394
CZ020,541397,Svatý Jan,258,109,367,99.73,68.40,538
CZ020,541419,Štětkovice,115,75,190,98.45,70.96,272
CZ020,541427,Tochovice,208,171,379,99.74,75.25,505
CZ020,541451,Třebsko,93,70,163,99.39,80.88,204
CZ020,541508,Věšín,200,174,374,99.47,71.08,529
CZ020,541516,Višňová,252,169,421,100.00,77.53,543
CZ020,541524,Volenice,135,108,243,98.78,76.64,321
CZ020,541541,Voznice,300,101,401,99.50,75.89,531
CZ020,541567,Vranovice,95,92,187,99.47,75.20,250
CZ020,541583,Vysoká u Příbramě,144,86,230,98.71,80.07,291
CZ020,541591,Vysoký Chlumec,350,143,493,99.80,74.51,663
CZ020,541613,Zalužany,100,110,210,100.00,78.65,267
CZ020,564214,Počaply,37,15,52,98.11,65.43,81
CZ020,564222,Nestrašovice,18,29,47,100.00,85.45,55
CZ020,564249,Chrást,57,55,112,99.12,69.33,163
CZ020,564257,Horčápsko,47,21,68,100.00,82.93,82
CZ020,564273,Svojšice,42,27,69,100.00,83.13,83
CZ020,564320,Zbenice,36,53,89,100.00,79.46,112
CZ020,564338,Županovice,31,15,46,100.00,76.67,60
CZ020,564346,Lazsko,72,54,126,99.21,76.97,165
CZ020,564362,Vrančice,80,27,107,100.00,76.43,140
CZ020,564389,Radětice,51,52,103,99.04,71.23,146
CZ020,564419,Cetyně,46,62,108,100.00,81.82,132
CZ020,564478,Narysov,106,71,177,98.88,77.16,232
CZ020,564486,Podlesí,405,247,652,99.85,74.29,879
CZ020,564508,Dubno,135,81,216,99.54,80.97,268
CZ020,564524,Nepomuk,65,65,130,100.00,69.15,188
CZ020,564559,Bohostice,65,65,130,99.24,71.58,183
CZ020,564583,Starosedlský Hrádek,32,51,83,100.00,72.81,114
CZ020,564605,Hlubyně,40,50,90,100.00,72.58,124
CZ020,564630,Sedlice,93,78,171,99.42,80.00,215
CZ020,564664,Bukovany,27,35,62,100.00,87.32,71
CZ020,598330,Tušovice,32,31,63,100.00,76.83,82
CZ020,598372,Ostrov,59,30,89,100.00,81.65,109
CZ020,598381,Dubenec,138,292,430,100.00,50.12,858
CZ020,598402,Háje,223,113,336,99.12,79.39,427
CZ020,598411,Lhota u Příbramě,156,132,288,99.31,75.32,385
CZ020,598429,Trhové Dušníky,162,82,244,99.19,72.14,341
CZ020,598437,Vševily,57,34,91,100.00,75.83,120
CZ020,598461,Kňovice,117,79,196,98.49,76.25,261
CZ020,598470,Osečany,112,54,166,100.00,74.44,223
CZ020,598488,Radíč,67,57,124,100.00,71.26,174
CZ020,599204,Korkyně,57,28,85,100.00,80.19,106
CZ020,599298,Drahenice,61,43,104,99.05,79.55,132
CZ020,599751,Modřovice,39,16,55,100.00,78.57,70
CZ020,529699,Velká Chmelištná,20,22,42,100.00,72.41,58
CZ020,529711,Drahouš,17,28,45,100.00,67.16,67
CZ020,541656,Rakovník,4606,3605,8211,99.56,69.05,11946
CZ020,541672,Branov,52,74,126,100.00,75.00,168
CZ020,541699,Čistá,228,235,463,98.51,64.92,724
CZ020,541729,Hořesedly,63,137,200,99.01,66.01,306
CZ020,541737,Hořovičky,57,144,201,100.00,56.94,353
CZ020,541761,Hřebečníky,76,81,157,98.74,74.65,213
CZ020,541770,Hředle,118,189,307,98.71,68.50,454
CZ020,541818,Chrášťany,185,167,352,99.44,66.67,531
CZ020,541834,Jesenice,370,461,831,99.52,66.11,1263
CZ020,541877,Kněževes,249,324,573,99.83,71.75,800
CZ020,541893,Kolešovice,186,252,438,99.77,64.84,677
CZ020,541907,Kounov,96,182,278,99.64,67.39,414
CZ020,541940,Kroučová,64,81,145,100.00,66.51,218
CZ020,541966,Krupá,122,141,263,99.62,73.33,360
CZ020,541974,Krušovice,195,145,340,99.42,74.19,461
CZ020,541982,Křivoklát,231,148,379,99.48,69.53,548
CZ020,542008,Lašovice,37,22,59,100.00,59.00,100
CZ020,542016,Lišany,176,195,371,98.67,69.63,540
CZ020,542032,Lubná,314,275,589,99.66,74.81,790
CZ020,542041,Lužná,590,500,1090,99.73,72.24,1513
CZ020,542067,Městečko,131,108,239,100.00,67.13,356
CZ020,542075,Milostín,66,115,181,99.45,70.27,259
CZ020,542105,Mšec,275,214,489,99.59,70.65,695
CZ020,542113,Mšecké Žehrovice,195,170,365,98.38,76.97,482
CZ020,542121,Mutějovice,219,214,433,100.00,67.34,643
CZ020,542130,Nesuchyně,120,127,247,98.80,74.40,336
CZ020,542164,Nové Strašecí,2033,1047,3080,99.39,71.92,4309
CZ020,542181,Nový Dům,57,45,102,100.00,79.07,129
CZ020,542199,Olešná,220,144,364,99.45,74.54,491
CZ020,542202,Oráčov,131,285,416,99.76,70.80,589
CZ020,542211,Panoší Újezd,92,68,160,100.00,70.48,227
CZ020,542229,Petrovice,75,93,168,99.41,73.80,229
CZ020,542237,Pochvalov,64,97,161,98.77,78.74,207
CZ020,542253,Příčina,59,64,123,100.00,69.89,176
CZ020,542270,Pšovlky,67,84,151,99.34,70.70,215
CZ020,542288,Pustověty,40,35,75,98.68,71.03,107
CZ020,542326,Ruda,224,216,440,100.00,70.51,624
CZ020,542334,Rynholec,343,199,542,99.45,69.16,788
CZ020,542351,Řevničov,496,338,834,99.17,72.94,1153
CZ020,542369,Senec,73,78,151,99.34,71.36,213
CZ020,542377,Senomaty,378,342,720,99.59,73.55,983
CZ020,542385,Skryje,69,38,107,99.07,80.60,134
CZ020,542415,Slabce,239,194,433,100.00,73.39,590
CZ020,542431,Srbeč,72,117,189,99.47,75.10,253
CZ020,542458,Svojetín,105,90,195,100.00,68.18,286
CZ020,542466,Sýkořice,197,147,344,99.42,73.93,468
CZ020,542474,Šanov,177,138,315,100.00,72.58,434
CZ020,542504,Třeboc,45,54,99,99.00,76.92,130
CZ020,542512,Třtice,154,125,279,99.64,68.46,409
CZ020,542563,Velká Buková,89,80,169,100.00,76.13,222
CZ020,542598,Všetaty,93,103,196,98.99,76.15,260
CZ020,542601,Zavidov,95,104,199,100.00,69.82,285
CZ020,542610,Zbečno,239,140,379,98.96,79.63,481
CZ020,544248,Pavlíkov,321,345,666,99.85,78.84,846
CZ020,565041,Břežany,45,33,78,100.00,71.56,109
CZ020,565130,Všesulov,21,29,50,100.00,60.98,82
CZ020,565181,Děkov,55,38,93,100.00,53.76,173
CZ020,565199,Kolešov,23,50,73,100.00,65.77,111
CZ020,565202,Hracholusky,34,21,55,100.00,79.71,69
CZ020,565261,Přílepy,74,51,125,99.21,65.97,191
CZ020,565270,Janov,44,54,98,98.00,78.13,128
CZ020,565288,Karlova Ves,35,43,78,98.73,81.44,97
CZ020,565326,Švihov,19,18,37,100.00,77.08,48
CZ020,565334,Hvozd,42,63,105,98.13,73.79,145
CZ020,565351,Krakov,43,41,84,100.00,81.55,103
CZ020,565369,Krakovec,19,19,38,100.00,69.09,55
CZ020,565377,Malinová,35,32,67,100.00,79.76,84
CZ020,565385,Kozojedy,26,34,60,100.00,88.24,68
CZ020,565407,Smilovice,22,21,43,100.00,76.79,56
CZ020,565423,Bdín,28,20,48,100.00,81.36,59
CZ020,565440,Kalivody,36,30,66,100.00,75.86,87
CZ020,565466,Milý,75,52,127,100.00,75.60,168
CZ020,565504,Řeřichy,35,33,68,100.00,77.27,88
CZ020,565512,Václavy,12,23,35,100.00,61.40,57
CZ020,598496,Šípy,45,42,87,96.67,69.23,130
CZ020,598500,Krty,20,49,69,100.00,74.19,93
CZ020,598518,Žďár,23,33,56,98.25,65.52,87
CZ020,598526,Roztoky,327,263,590,99.16,72.47,821
CZ020,598577,Přerubenice,36,14,50,100.00,78.13,64
CZ020,598585,Nezabudice,46,23,69,98.57,76.09,92
CZ020,599760,Račice,60,39,99,100.00,74.44,133
CZ020,513482,Vysoký Újezd,86,60,146,99.32,88.02,167
CZ020,529303,Benešov,5702,3394,9096,99.44,71.91,12722
CZ020,529451,Bystřice,1410,1147,2557,99.46,73.39,3503
CZ020,529478,Čakov,58,26,84,100.00,84.85,99
CZ020,529486,Čechtice,520,342,862,99.42,75.99,1141
CZ020,529516,Čerčany,1132,513,1645,99.70,75.17,2195
CZ020,529532,Červený Újezd,119,81,200,98.04,77.57,263
CZ020,529541,Český Šternberk,65,35,100,100.00,75.19,133
CZ020,529567,Čtyřkoly,356,117,473,99.58,82.64,576
CZ020,529621,Divišov,563,382,945,99.58,73.06,1299
CZ020,529648,Dolní Kralovice,264,262,526,99.25,74.65,710
CZ020,529702,Heřmaničky,224,207,431,99.54,73.68,589
CZ020,529737,Hulice,89,72,161,98.77,69.36,235
CZ020,529745,Hvězdonice,143,58,201,99.01,77.78,261
CZ020,529770,Chlum,28,72,100,100.00,86.96,115
CZ020,529788,Chmelná,76,27,103,98.10,89.74,117
CZ020,529796,Chocerady,474,272,746,99.33,76.09,987
CZ020,529818,Chotýšany,217,151,368,100.00,76.51,481
CZ020,529842,Jankov,291,224,515,99.61,68.75,752
CZ020,529851,Javorník,44,53,97,100.00,84.35,115
CZ020,529907,Keblov,48,66,114,96.61,75.64,156
CZ020,529931,Kondrac,188,122,310,99.04,81.51,384
CZ020,529940,Kozmice,140,80,220,100.00,75.43,293
CZ020,529958,Krhanice,385,199,584,99.49,73.74,796
CZ020,529974,Krňany,201,88,289,99.66,71.96,403
CZ020,529991,Křečovice,276,230,506,99.41,77.12,660
CZ020,530000,Křivsoudov,163,89,252,99.60,70.28,360
CZ020,530026,Kuňovice,34,23,57,100.00,86.36,66
CZ020,530051,Lešany,268,185,453,100.00,73.90,613
CZ020,530069,Libež,56,90,146,100.00,83.43,175
CZ020,530093,Loket,245,146,391,100.00,79.80,490
CZ020,530107,Louňovice pod Blaníkem,219,170,389,98.48,75.67,522
CZ020,530115,Maršovice,247,198,445,99.33,74.54,601
CZ020,530158,Mezno,122,96,218,98.20,75.77,293
CZ020,530166,Miličín,285,230,515,99.04,74.29,700
CZ020,530174,Miřetice,82,55,137,100.00,76.54,179
CZ020,530191,Mnichovice,63,85,148,99.33,80.98,184
CZ020,530204,Mrač,311,197,508,98.83,78.96,651
CZ020,530212,Načeradec,327,267,594,100.00,67.89,875
CZ020,530263,Nespeky,298,164,462,99.78,78.78,589
CZ020,530298,Netvořice,373,284,657,99.55,73.66,896
CZ020,530301,Neustupov,153,155,308,99.04,73.35,424
CZ020,530310,Neveklov,869,576,1445,99.59,69.61,2086
CZ020,530344,Olbramovice,414,425,839,99.41,78.15,1080
CZ020,530352,Ostředek,161,76,237,99.58,74.61,319
CZ020,530409,Petroupim,121,53,174,99.43,70.85,247
CZ020,530441,Poříčí nad Sázavou,567,276,843,99.53,76.67,1106
CZ020,530450,Postupice,431,322,753,98.95,72.57,1050
CZ020,530476,Pravonín,197,149,346,99.71,74.62,465
CZ020,530492,Přestavlky u Čerčan,152,93,245,98.79,80.26,309
CZ020,530514,Psáře,55,24,79,100.00,68.10,116
CZ020,530522,Rabyně,109,69,178,100.00,77.39,230
CZ020,530531,Radošovice,130,101,231,99.57,75.82,306
CZ020,530549,Rataje,51,50,101,100.00,73.19,138
CZ020,530611,Smilkov,75,98,173,100.00,74.57,232
CZ020,530638,Soběhrdy,181,91,272,99.63,83.23,328
CZ020,530689,Struhařov,346,260,606,99.51,81.64,746
CZ020,530701,Střezimíř,113,79,192,100.00,73.00,263
CZ020,530719,Studený,52,23,75,100.00,84.27,89
CZ020,530743,Bílkovice,56,82,138,100.00,77.97,177
CZ020,530751,Tehov,118,69,187,99.47,72.87,258
CZ020,530760,Teplýšovice,196,108,304,99.35,79.90,383
CZ020,530778,Tichonice,66,75,141,100.00,84.43,167
CZ020,530816,Trhový Štěpánov,429,303,732,99.86,72.07,1017
CZ020,530841,Týnec nad Sázavou,1966,1318,3284,99.52,73.32,4502
CZ020,530867,Veliš,95,115,210,98.13,75.89,282
CZ020,530883,Vlašim,3430,2759,6189,99.63,69.08,8993
CZ020,530891,Vojkov,156,139,295,100.00,73.93,399
CZ020,530905,Votice,1265,1187,2452,99.72,69.81,3531
CZ020,530913,Vracovice,123,113,236,100.00,74.76,317
CZ020,530921,Vranov,205,75,280,99.29,79.89,353
CZ020,530948,Vrchotovy Janovice,289,270,559,99.64,72.57,773
CZ020,531022,Zdislavice,152,184,336,99.70,81.80,412
CZ020,531031,Kamberk,64,42,106,100.00,74.65,142
CZ020,531049,Zvěstov,121,94,215,99.54,68.14,317
CZ020,532037,Chrášťany,88,57,145,99.32,74.11,197
CZ020,532045,Chlístov,193,71,264,98.88,79.94,334
CZ020,532061,Václavice,192,156,348,100.00,75.87,460
CZ020,532096,Borovnice,27,28,55,100.00,84.62,65
CZ020,532134,Ješetice,35,27,62,100.00,56.88,109
CZ020,532151,Drahňovice,49,19,68,100.00,76.40,89
CZ020,532193,Lštění,198,78,276,98.92,78.43,357
CZ020,532231,Slověnice,16,6,22,100.00,84.62,26
CZ020,532258,Litichovice,26,21,47,95.92,85.96,57
CZ020,532266,Všechlapy,66,18,84,98.82,87.63,97
CZ020,532304,Třebešice,50,17,67,100.00,74.44,90
CZ020,532380,Blažejovice,48,33,81,100.00,89.01,91
CZ020,532436,Snět,39,26,65,100.00,81.25,80
CZ020,532509,Šetějovice,21,26,47,100.00,83.93,56
CZ020,532541,Tomice,27,55,82,100.00,80.39,102
CZ020,532550,Ratměřice,105,59,164,99.39,69.33,238
CZ020,532568,Bernartice,69,74,143,100.00,81.25,176
CZ020,532592,Tisem,73,63,136,98.55,75.41,183
CZ020,532606,Choratice,30,14,44,100.00,78.57,56
CZ020,532614,Vodslivy,28,24,52,100.00,72.22,72
CZ020,532649,Popovice,85,84,169,98.83,69.80,245
CZ020,532690,Ctiboř,59,42,101,100.00,84.17,120
CZ020,532746,Děkanovice,23,19,42,97.67,87.76,49
CZ020,532843,Dunice,19,32,51,100.00,89.47,57
CZ020,532878,Chleby,16,13,29,100.00,72.50,40
CZ020,532886,Chářovice,60,60,120,98.36,78.71,155
CZ020,532924,Bukovany,289,152,441,99.55,75.08,590
CZ020,532932,Hradiště,11,9,20,95.24,80.77,26
CZ020,532941,Řimovice,77,59,136,100.00,75.14,181
CZ020,533076,Pavlovice,90,56,146,100.00,77.25,189
CZ020,533084,Kladruby,181,122,303,100.00,86.08,352
CZ020,534382,Sázava,1241,851,2092,99.57,71.58,2938
CZ020,538680,Pyšely,903,307,1210,99.34,77.19,1578
CZ020,538710,Řehenice,207,81,288,98.97,75.39,386
CZ020,571415,Xaverov,29,6,35,97.22,78.26,46
CZ020,599361,Strojetice,45,35,80,100.00,72.73,110
CZ020,599379,Stranný,47,25,72,100.00,81.82,88
CZ020,599387,Soutice,56,89,145,100.00,67.44,215
CZ020,599395,Ostrov,24,18,42,100.00,67.74,62
CZ020,531057,Beroun,7000,3410,10410,99.56,70.92,14748
CZ020,531073,Běštín,109,98,207,100.00,77.82,266
CZ020,531081,Broumy,328,268,596,99.67,77.97,767
CZ020,531090,Březová,138,72,210,100.00,82.68,254
CZ020,531103,Bubovice,234,78,312,99.36,76.21,412
CZ020,531120,Bzová,157,115,272,100.00,72.92,373
CZ020,531138,Cerhovice,398,274,672,100.00,75.00,896
CZ020,531154,Drozdov,264,201,465,99.15,80.03,586
CZ020,531162,Felbabka,102,82,184,100.00,82.51,223
CZ020,531171,Hlásná Třebaň,553,161,714,99.17,80.54,894
CZ020,531189,Hořovice,2017,1372,3389,99.62,68.91,4937
CZ020,531201,Hostomice,621,361,982,99.70,72.75,1354
CZ020,531219,Hředle,145,108,253,100.00,78.82,321
CZ020,531227,Hudlice,412,314,726,98.91,74.97,979
CZ020,531235,Hvozdec,110,64,174,100.00,83.25,209
CZ020,531243,Hýskov,857,306,1163,99.83,75.90,1535
CZ020,531251,Chaloupky,222,107,329,98.50,80.68,414
CZ020,531294,Chyňava,685,405,1090,99.54,74.51,1475
CZ020,531308,Jivina,49,66,115,100.00,73.25,157
CZ020,531316,Karlštejn,359,154,513,99.81,78.35,656
CZ020,531324,Komárov,745,618,1363,99.56,72.47,1889
CZ020,531332,Koněprusy,108,49,157,100.00,77.72,202
CZ020,531375,Kublov,213,156,369,99.73,72.27,512
CZ020,531448,Libomyšl,168,137,305,98.07,71.33,436
CZ020,531456,Liteň,388,280,668,99.55,73.74,910
CZ020,531464,Loděnice,680,300,980,99.19,74.14,1334
CZ020,531472,Lochovice,410,287,697,99.15,70.58,996
CZ020,531529,Měňany,94,55,149,100.00,59.84,249
CZ020,531537,Mezouň,293,77,370,98.40,81.56,461
CZ020,531545,Mořina,352,107,459,99.35,76.74,602
CZ020,531588,Neumětely,206,130,336,99.70,75.06,449
CZ020,531596,Nižbor,810,393,1203,99.09,72.83,1667
CZ020,531600,Nový Jáchymov,266,171,437,98.87,74.70,593
CZ020,531626,Olešná,155,117,272,99.63,71.84,380
CZ020,531634,Osek,295,188,483,99.79,74.23,652
CZ020,531642,Osov,135,69,204,99.03,78.33,263
CZ020,531669,Otročiněves,184,129,313,99.05,80.41,393
CZ020,531685,Podluhy,215,162,377,99.47,73.31,517
CZ020,531693,Praskolesy,319,222,541,99.82,79.24,684
CZ020,531715,Rpety,160,136,296,100.00,75.32,393
CZ020,531740,Skuhrov,230,115,345,100.00,77.88,443
CZ020,531758,Srbsko,249,96,345,100.00,82.14,420
CZ020,531766,Stašov,155,105,260,100.00,72.22,360
CZ020,531782,Suchomasty,147,127,274,99.64,67.07,410
CZ020,531791,Svatá,184,135,319,99.38,77.91,412
CZ020,531804,Svatý Jan pod Skalou,96,20,116,100.00,79.45,146
CZ020,531812,Svinaře,410,103,513,99.23,80.91,639
CZ020,531839,Tetín,328,161,489,99.19,71.35,691
CZ020,531847,Tlustice,328,251,579,99.48,77.60,750
CZ020,531855,Tmaň,356,290,646,99.54,68.90,942
CZ020,531880,Trubská,74,56,130,100.00,80.75,161
CZ020,531901,Újezd,298,105,403,99.75,77.74,521
CZ020,531910,Velký Chlumec,180,97,277,99.64,78.31,355
CZ020,531944,Vráž,450,250,700,99.43,73.56,957
CZ020,531952,Všeradice,179,85,264,100.00,76.97,343
CZ020,531961,Vysoký Újezd,643,176,819,98.91,81.58,1015
CZ020,531979,Zadní Třebaň,456,139,595,100.00,78.39,759
CZ020,531995,Zaječov,451,390,841,99.64,73.07,1155
CZ020,532002,Záluží,119,171,290,99.32,73.92,395
CZ020,532011,Zdice,1302,864,2166,99.63,70.37,3091
CZ020,532029,Žebrák,772,462,1234,99.28,75.02,1657
CZ020,533106,Trubín,206,112,318,100.00,81.96,388
CZ020,533203,Králův Dvůr,3361,1480,4841,99.77,70.46,6893
CZ020,533319,Malá Víska,33,27,60,100.00,73.17,82
CZ020,533335,Lhotka,104,110,214,99.07,76.60,282
CZ020,533602,Nenačovice,105,80,185,97.88,81.82,231
CZ020,533670,Chrustenice,444,139,583,99.66,78.52,745
CZ020,533793,Korno,42,40,82,100.00,90.11,91
CZ020,533912,Mořinka,83,26,109,99.09,79.71,138
CZ020,533939,Lážovice,37,22,59,100.00,71.95,82
CZ020,533963,Skřipel,42,30,72,100.00,72.00,100
CZ020,534048,Vižina,108,68,176,100.00,79.73,222
CZ020,534072,Kotopeky,116,83,199,99.50,78.43,255
CZ020,534111,Otmíče,54,48,102,100.00,80.31,127
CZ020,534145,Bykoš,79,66,145,100.00,77.13,188
CZ020,534218,Málkov,35,29,64,100.00,68.82,93
CZ020,534234,Vinařice,47,21,68,100.00,85.00,80
CZ020,534269,Nesvačily,63,49,112,100.00,84.21,133
CZ020,534285,Podbrdy,100,68,168,100.00,88.42,190
CZ020,534404,Lužce,41,24,65,100.00,68.42,95
CZ020,534421,Bavoryně,118,84,202,99.02,68.69,297
CZ020,534447,Chodouň,251,136,387,99.74,75.19,516
CZ020,534455,Chlustina,97,51,148,100.00,76.68,193
CZ020,534463,Točník,96,47,143,100.00,71.14,201
CZ020,599417,Železná,91,65,156,100.00,72.56,215
CZ020,512991,Drnek,67,46,113,100.00,75.84,149
CZ020,513032,Kamenný Most,100,123,223,99.55,68.50,327
CZ020,513041,Lhota,265,142,407,99.75,79.07,516
CZ020,513075,Hobšovice,97,82,179,99.44,63.38,284
CZ020,513113,Malé Přítočno,120,37,157,100.00,71.36,220
CZ020,513130,Dolany,116,40,156,99.36,75.48,208
CZ020,532053,Kladno,19160,13389,32549,99.60,63.54,51455
CZ020,532070,Běloky,75,40,115,100.00,78.23,147
CZ020,532088,Beřovice,132,58,190,98.96,70.07,274
CZ020,532100,Blevice,83,84,167,100.00,73.25,228
CZ020,532118,Brandýsek,762,421,1183,99.00,74.24,1611
CZ020,532126,Braškov,489,192,681,99.85,79.05,864
CZ020,532142,Bratronice,361,192,553,99.46,73.35,758
CZ020,532169,Buštěhrad,1416,586,2002,99.65,75.56,2660
CZ020,532177,Tuřany,224,170,394,100.00,76.65,514
CZ020,532185,Cvrčovice,270,149,419,99.29,74.04,570
CZ020,532207,Černuc,265,242,507,99.80,65.72,773
CZ020,532223,Doksy,685,268,953,99.48,74.73,1282
CZ020,532274,Družec,413,225,638,99.38,75.80,847
CZ020,532282,Dřetovice,132,117,249,98.81,73.47,343
CZ020,532291,Dřínov,80,95,175,98.87,65.80,269
CZ020,532312,Horní Bezděkov,320,131,451,99.34,82.40,551
CZ020,532321,Hořešovice,73,83,156,100.00,73.58,212
CZ020,532339,Hospozín,137,136,273,99.64,61.99,442
CZ020,532347,Hostouň,567,241,808,99.51,76.53,1061
CZ020,532355,Hradečno,221,103,324,99.69,74.94,435
CZ020,532363,Hrdlív,196,127,323,100.00,80.55,401
CZ020,532371,Hřebeč,788,356,1144,98.79,73.76,1570
CZ020,532398,Chržín,95,74,169,99.41,72.34,235
CZ020,532401,Jarpice,89,65,154,99.35,66.24,234
CZ020,532410,Jedomělice,133,98,231,99.57,71.17,326
CZ020,532428,Jemníky,106,43,149,99.33,74.26,202
CZ020,532444,Kačice,384,314,698,99.29,70.16,1002
CZ020,532452,Kamenné Žehrovice,581,411,992,100.00,74.20,1337
CZ020,532461,Klobuky,234,272,506,99.41,64.35,791
CZ020,532479,Kmetiněves,76,83,159,99.38,71.75,223
CZ020,532487,Knovíz,206,142,348,99.71,75.05,465
CZ020,532495,Koleč,168,118,286,100.00,65.15,439
CZ020,532517,Kvílice,18,35,53,100.00,79.10,67
CZ020,532525,Kyšice,263,112,375,99.73,78.99,476
CZ020,532533,Ledce,152,130,282,99.65,72.94,388
CZ020,532576,Libušín,885,691,1576,99.24,65.15,2439
CZ020,532584,Lidice,211,111,322,100.00,78.02,414
CZ020,532622,Makotřasy,180,98,278,100.00,77.93,358
CZ020,532631,Malé Kyšice,229,96,325,99.39,77.30,423
CZ020,532657,Malíkovice,107,99,206,98.56,66.35,315
CZ020,532665,Neuměřice,119,102,221,100.00,66.57,332
CZ020,532681,Otvovice,236,222,458,100.00,76.97,595
CZ020,532711,Pavlov,56,42,98,98.99,74.44,133
CZ020,532720,Pchery,556,533,1089,99.45,71.24,1537
CZ020,532738,Pletený Újezd,240,114,354,98.88,76.50,468
CZ020,532754,Podlešín,95,91,186,100.00,70.72,263
CZ020,532762,Pozdeň,136,126,262,99.24,74.16,356
CZ020,532771,Přelíc,116,98,214,99.53,69.01,313
CZ020,532797,Řisuty,135,70,205,99.51,71.28,289
CZ020,532801,Sazená,122,67,189,98.44,73.95,261
CZ020,532819,Slaný,4841,3186,8027,99.57,68.68,11740
CZ020,532827,Slatina,175,158,333,99.70,72.61,460
CZ020,532835,Smečno,563,410,973,99.08,61.67,1594
CZ020,532851,Stehelčeves,348,203,551,100.00,78.16,705
CZ020,532860,Stochov,1459,1326,2785,99.43,65.03,4309
CZ020,532908,Svinařov,209,215,424,100.00,73.10,580
CZ020,532916,Šlapanice,38,55,93,98.94,69.12,136
CZ020,532959,Třebichovice,168,144,312,99.36,67.53,465
CZ020,532967,Třebíz,90,53,143,100.00,79.44,180
CZ020,532975,Třebusice,138,130,268,98.89,70.03,387
CZ020,532983,Tuchlovice,947,556,1503,99.67,73.25,2060
CZ020,533009,Uhy,99,102,201,100.00,66.56,302
CZ020,533017,Unhošť,1935,793,2728,99.42,74.34,3698
CZ020,533025,Velká Dobrá,780,331,1111,99.20,79.38,1411
CZ020,533033,Velké Přítočno,392,193,585,99.83,74.78,785
CZ020,533041,Velvary,929,762,1691,99.24,71.69,2377
CZ020,533050,Vinařice,698,781,1479,99.80,68.26,2174
CZ020,533068,Vraný,196,197,393,98.74,68.38,582
CZ020,533092,Zákolany,238,128,366,99.46,75.56,487
CZ020,533114,Zlonice,470,601,1071,99.35,60.77,1774
CZ020,533122,Zvoleněves,203,250,453,99.78,66.18,686
CZ020,533149,Žilina,322,179,501,99.40,76.95,655
CZ020,533157,Žižice,202,199,401,99.01,75.14,539
CZ020,535010,Běleč,114,69,183,100.00,73.49,249
CZ020,535095,Loucká,27,46,73,100.00,68.81,109
CZ020,535109,Královice,63,76,139,98.58,73.44,192
CZ020,535125,Bílichov,54,64,118,100.00,71.52,165
CZ020,535150,Hořešovičky,35,37,72,100.00,70.59,102
CZ020,541991,Lány,891,432,1323,99.70,78.13,1701
CZ020,551457,Studeněves,174,83,257,100.00,70.22,366
CZ020,564087,Poštovice,61,70,131,99.24,78.11,169
CZ020,564125,Plchov,55,77,132,100.00,75.00,176
CZ020,564150,Libochovičky,30,14,44,100.00,77.19,57
CZ020,564192,Páleč,50,74,124,99.20,76.69,163
CZ020,571423,Zichovec,90,38,128,98.46,87.84,148
CZ020,571431,Vrbičany,36,78,114,99.13,66.47,173
CZ020,571512,Kutrovice,42,24,66,100.00,75.86,87
CZ020,571521,Neprobylice,52,33,85,100.00,70.25,121
CZ020,571555,Líský,31,25,56,100.00,70.00,80
CZ020,571598,Zájezd,39,30,69,98.57,76.92,91
CZ020,571601,Libovice,142,72,214,100.00,75.09,285
CZ020,599425,Želenice,41,51,92,98.92,63.70,146
CZ020,599433,Svárov,260,73,333,99.40,74.61,449
CZ020,599441,Stradonice,20,35,55,100.00,52.38,105
CZ020,513148,Polní Voděrady,59,53,112,99.12,67.66,167
CZ020,513164,Ždánice,120,99,219,99.10,77.00,287
CZ020,513181,Dománovice,40,34,74,98.67,75.00,100
CZ020,513202,Zalešany,43,34,77,100.00,75.49,102
CZ020,513237,Polní Chrčice,62,47,109,98.20,76.03,146
CZ020,513261,Žabonosy,77,87,164,99.39,82.50,200
CZ020,513270,Lipec,42,66,108,96.43,77.24,145
CZ020,513288,Mrzky,67,43,110,100.00,73.83,149
CZ020,513369,Přehvozdí,147,42,189,100.00,74.12,255
CZ020,513393,Přistoupim,135,117,252,98.82,72.86,350
CZ020,513415,Kbel,95,48,143,100.00,82.18,174
CZ020,513423,Pašinka,118,87,205,100.00,71.43,287
CZ020,533165,Kolín,9342,6521,15863,99.55,68.15,23393
CZ020,533173,Barchovice,93,58,151,100.00,78.65,192
CZ020,533181,Bečváry,298,294,592,99.66,70.46,843
CZ020,533190,Bělušice,63,86,149,100.00,64.66,232
CZ020,533211,Břežany I,92,74,166,100.00,68.31,243
CZ020,533220,Břežany II,292,134,426,99.30,72.71,590
CZ020,533238,Býchory,230,157,387,100.00,76.33,507
CZ020,533246,Cerhenice,550,500,1050,99.53,74.26,1422
CZ020,533262,Červené Pečky,715,396,1111,99.73,74.42,1497
CZ020,533271,Český Brod,2602,1166,3768,99.55,69.58,5441
CZ020,533289,Dobřichov,290,171,461,99.78,74.16,623
CZ020,533297,Dolní Chvatliny,130,135,265,99.62,72.68,366
CZ020,533301,Doubravčice,477,222,699,99.86,80.57,870
CZ020,533327,Horní Kruty,175,90,265,99.62,68.21,390
CZ020,533343,Chotutice,143,129,272,100.00,71.96,378
CZ020,533351,Chrášťany,199,174,373,100.00,70.11,532
CZ020,533360,Jestřabí Lhota,184,121,305,99.67,76.69,399
CZ020,533386,Klučov,381,224,605,100.00,73.07,828
CZ020,533394,Konárovice,319,197,516,99.61,69.44,746
CZ020,533408,Kořenice,149,182,331,99.40,67.55,493
CZ020,533424,Kouřim,617,501,1118,99.73,73.56,1524
CZ020,533441,Krakovany,302,237,539,100.00,75.38,715
CZ020,533459,Krupá,136,107,243,99.59,75.31,324
CZ020,533467,Křečhoř,177,131,308,99.35,73.99,419
CZ020,533475,Libenice,93,80,173,99.43,70.16,248
CZ020,533483,Libodřice,88,80,168,99.41,70.71,239
CZ020,533505,Lošany,97,85,182,98.91,75.72,243
CZ020,533513,Malotice,112,95,207,100.00,76.67,270
CZ020,533521,Nebovidy,257,168,425,99.07,78.43,547
CZ020,533530,Nová Ves I,410,337,747,99.73,72.02,1040
CZ020,533556,Ohaře,95,80,175,100.00,71.43,245
CZ020,533572,Ovčáry,241,247,488,99.39,77.81,631
CZ020,533581,Plaňany,474,469,943,99.58,67.12,1411
CZ020,533599,Polepy,255,137,392,98.99,76.30,519
CZ020,533611,Přišimasy,340,111,451,99.78,70.96,637
CZ020,533629,Radim,382,325,707,99.44,76.62,928
CZ020,533637,Radovesnice I,152,90,242,98.37,79.35,310
CZ020,533645,Radovesnice II,152,142,294,98.00,71.26,421
CZ020,533653,Ratboř,177,170,347,99.43,81.92,426
CZ020,533661,Rostoklaty,215,90,305,99.67,70.57,435
CZ020,533696,Skvrňov,58,67,125,98.43,75.15,169
CZ020,533700,Starý Kolín,560,362,922,99.78,73.57,1256
CZ020,533726,Svojšice,126,148,274,99.64,70.51,390
CZ020,533734,Tismice,161,114,275,100.00,65.48,420
CZ020,533742,Toušice,146,131,277,100.00,69.77,397
CZ020,533751,Třebovle,160,129,289,99.31,69.45,419
CZ020,533769,Tři Dvory,320,259,579,99.83,77.47,750
CZ020,533777,Tuchoraz,188,113,301,100.00,75.82,397
CZ020,533785,Tuklaty,412,194,606,99.67,79.37,766
CZ020,533807,Týnec nad Labem,660,491,1151,99.48,69.42,1668
CZ020,533815,Uhlířská Lhota,98,131,229,98.71,75.08,309
CZ020,533823,Veletov,81,62,143,98.62,72.14,201
CZ020,533831,Velim,791,502,1293,99.69,76.07,1705
CZ020,533840,Velký Osek,791,551,1342,99.41,69.98,1929
CZ020,533858,Veltruby,438,369,807,99.38,71.67,1133
CZ020,533866,Vitice,343,235,578,99.31,65.61,887
CZ020,533882,Volárna,145,146,291,99.66,68.54,426
CZ020,533891,Vrbčany,95,105,200,100.00,62.31,321
CZ020,533921,Zásmuky,592,482,1074,99.81,69.46,1549
CZ020,533947,Žiželice,399,372,771,99.87,69.74,1107
CZ020,534994,Choťovice,77,50,127,100.00,71.75,177
CZ020,537641,Pečky,1415,1211,2626,99.66,72.95,3612
CZ020,537675,Pňov-Předhradí,228,130,358,100.00,76.01,471
CZ020,537705,Poříčany,576,324,900,99.78,78.16,1154
CZ020,537748,Ratenice,196,136,332,99.10,72.51,462
CZ020,537888,Tatce,217,151,368,100.00,74.65,493
CZ020,538035,Žehuň,142,121,263,100.00,71.66,367
CZ020,564681,Drahobudice,68,73,141,100.00,72.31,195
CZ020,564702,Masojedy,40,20,60,100.00,66.67,90
CZ020,564800,Hradešín,210,71,281,99.29,79.27,357
CZ020,564826,Vrátkov,116,48,164,100.00,74.89,219
CZ020,571636,Němčice,128,101,229,99.57,75.16,306
CZ020,571687,Klášterní Skalice,47,45,92,100.00,82.14,112
CZ020,571717,Kšely,77,49,126,99.21,73.41,173
CZ020,599301,Černíky,36,33,69,97.18,61.21,116
CZ020,599450,Grunta,26,27,53,98.15,80.60,67
CZ020,599476,Církvice,40,48,88,100.00,65.19,135
CZ020,599484,Krychnov,36,42,78,100.00,83.87,93
CZ020,526622,Rohozec,98,88,186,100.00,74.40,250
CZ020,528196,Podveky,75,59,134,100.00,72.83,184
CZ020,529524,Čejkovice,15,12,27,100.00,90.00,30
CZ020,529559,Dobrovítov,41,42,83,100.00,80.58,103
CZ020,530832,Brambory,26,47,73,100.00,76.04,96
CZ020,530859,Semtěš,75,69,144,100.00,71.29,202
CZ020,530875,Starkoč,44,56,100,100.00,74.07,135
CZ020,530930,Štipoklasy,41,43,84,100.00,71.79,117
CZ020,530956,Opatovice I,74,36,110,100.00,79.71,138
CZ020,530964,Bludov,12,5,17,100.00,80.95,21
CZ020,530972,Třebětín,23,37,60,100.00,66.67,90
CZ020,530981,Třebešice,71,74,145,99.32,66.06,221
CZ020,530999,Močovice,91,128,219,100.00,69.09,317
CZ020,531014,Vodranty,21,26,47,100.00,75.81,62
CZ020,531065,Souňov,59,35,94,100.00,78.33,120
CZ020,531111,Bernardov,46,50,96,98.97,66.44,146
CZ020,531197,Hlízov,246,119,365,98.92,78.01,473
CZ020,531260,Dolní Pohleď,34,40,74,98.67,78.13,96
CZ020,531278,Paběnice,96,27,123,100.00,74.10,166
CZ020,531286,Bratčice,120,122,242,99.18,76.49,319
CZ020,531341,Drobovice,81,154,235,100.00,73.44,320
CZ020,531359,Horky,101,107,208,99.52,74.64,280
CZ020,531367,Adamov,42,36,78,98.73,75.24,105
CZ020,531383,Schořov,31,25,56,100.00,80.00,70
CZ020,531391,Sudějov,39,24,63,100.00,86.30,73
CZ020,531405,Kobylnice,70,45,115,100.00,74.19,155
CZ020,531413,Hraběšín,31,39,70,100.00,76.92,91
CZ020,531421,Šebestěnice,36,17,53,100.00,84.13,63
CZ020,531430,Horka I,118,118,236,99.58,73.15,324
CZ020,531481,Horušice,35,68,103,99.04,75.36,138
CZ020,533955,Kutná Hora,6518,4124,10642,99.44,69.30,15451
CZ020,533971,Bílé Podolí,152,199,351,100.00,70.77,496
CZ020,533980,Bohdaneč,97,151,248,99.60,75.00,332
CZ020,533998,Církvice,461,320,781,99.74,75.73,1034
CZ020,534005,Čáslav,2977,2291,5268,99.43,69.30,7648
CZ020,534013,Černíny,141,119,260,100.00,77.84,334
CZ020,534021,Červené Janovice,189,193,382,100.00,70.09,545
CZ020,534030,Čestín,164,128,292,100.00,80.00,365
CZ020,534056,Horka II,139,112,251,99.60,73.68,342
CZ020,534064,Hostovlice,69,67,136,100.00,64.76,210
CZ020,534081,Chabeřice,88,68,156,100.00,69.96,223
CZ020,534099,Chlístovice,233,231,464,99.78,73.46,633
CZ020,534102,Chotusice,214,203,417,98.35,69.17,613
CZ020,534129,Kácov,277,194,471,100.00,75.97,620
CZ020,534137,Kluky,144,170,314,99.68,77.21,408
CZ020,534153,Krchleby,137,107,244,99.59,74.47,329
CZ020,534161,Křesetice,224,154,378,98.95,69.84,547
CZ020,534170,Ledečko,83,43,126,100.00,79.25,159
CZ020,534188,Malešov,338,261,599,99.50,71.92,837
CZ020,534196,Svatý Mikuláš,284,250,534,99.44,77.08,698
CZ020,534200,Miskovice,458,195,653,99.85,76.76,852
CZ020,534226,Nepoměřice,55,80,135,99.26,75.98,179
CZ020,534242,Nové Dvory,290,190,480,99.79,69.61,691
CZ020,534251,Okřesaneč,56,69,125,100.00,78.13,160
CZ020,534277,Onomyšl,78,88,166,99.40,69.58,240
CZ020,534293,Soběšín,53,59,112,100.00,72.73,154
CZ020,534307,Pertoltice,38,59,97,98.98,71.01,138
CZ020,534315,Petrovice I,81,101,182,100.00,71.94,253
CZ020,534323,Petrovice II,69,29,98,100.00,74.24,132
CZ020,534331,Potěhy,169,176,345,99.71,69.20,500
CZ020,534340,Rašovice,106,119,225,99.56,67.26,336
CZ020,534358,Rataje nad Sázavou,182,119,301,98.37,67.70,452
CZ020,534366,Řendějov,81,63,144,98.63,76.44,191
CZ020,534374,Samopše,75,42,117,100.00,67.63,173
CZ020,534391,Slavošov,36,55,91,98.91,71.88,128
CZ020,534412,Staňkovice,77,74,151,99.34,73.43,207
CZ020,534439,Suchdol,365,319,684,99.85,74.78,916
CZ020,534480,Tupadly,209,188,397,99.75,75.09,530
CZ020,534498,Uhlířské Janovice,881,818,1699,99.59,69.35,2460
CZ020,534501,Úmonín,169,154,323,99.69,78.07,415
CZ020,534510,Úžice,204,235,439,99.55,77.78,567
CZ020,534528,Vavřinec,158,171,329,99.70,76.92,429
CZ020,534536,Vidice,112,62,174,99.43,76.42,229
CZ020,534544,Vinaře,70,72,142,100.00,66.05,215
CZ020,534552,Vlačice,58,71,129,99.23,64.36,202
CZ020,534561,Vlastějovice,127,102,229,99.57,62.50,368
CZ020,534579,Vlkaneč,208,173,381,100.00,75.90,502
CZ020,534587,Vrdy,777,892,1669,99.94,71.20,2347
CZ020,534595,Záboří nad Labem,288,204,492,99.60,73.73,670
CZ020,534609,Zbizuby,118,158,276,99.28,72.77,382
CZ020,534617,Zbraslavice,443,380,823,99.16,72.17,1150
CZ020,534625,Zbýšov,187,213,400,100.00,75.47,530
CZ020,534633,Zruč nad Sázavou,1301,1142,2443,99.31,66.92,3682
CZ020,534641,Žáky,95,115,210,98.59,69.38,307
CZ020,534650,Žehušice,296,173,469,99.36,71.62,659
CZ020,534668,Žleby,303,431,734,99.59,69.14,1066
CZ020,551465,Košice,23,14,37,100.00,75.51,49
CZ020,571741,Třebonín,43,42,85,100.00,73.91,115
CZ020,529575,Medonosy,51,20,71,97.26,64.04,114
CZ020,529583,Tupadly,34,42,76,100.00,71.70,106
CZ020,531499,Hostín,108,73,181,98.37,73.60,250
CZ020,531502,Liblice,114,175,289,99.66,72.14,402
CZ020,531511,Zlončice,192,96,288,100.00,73.66,391
CZ020,531561,Tuhaň,233,188,421,99.53,70.15,603
CZ020,531570,Dobřeň,84,38,122,100.00,76.25,160
CZ020,531651,Kanina,30,28,58,98.31,68.60,86
CZ020,531677,Lobeč,53,38,91,98.91,73.60,125
CZ020,531707,Nosálov,84,36,120,100.00,70.18,171
CZ020,531731,Stránka,54,63,117,100.00,70.48,166
CZ020,531774,Kadlín,27,50,77,98.72,70.27,111
CZ020,531863,Nedomice,116,54,170,100.00,74.56,228
CZ020,531871,Jeviněves,119,56,175,100.00,84.13,208
CZ020,531898,Lhotka,145,70,215,99.54,82.44,262
CZ020,531928,Hostín u Vojkovic,99,89,188,100.00,72.31,260
CZ020,531936,Vidim,47,37,84,100.00,71.19,118
CZ020,531987,Dolní Zimoř,29,28,57,93.44,79.22,77
CZ020,532673,Olovnice,193,113,306,99.67,75.06,409
CZ020,534676,Mělník,6725,3742,10467,99.48,69.30,15183
CZ020,534714,Býkev,152,143,295,100.00,74.12,398
CZ020,534722,Byšice,425,343,768,99.22,73.23,1057
CZ020,534731,Cítov,380,293,673,99.85,72.01,936
CZ020,534749,Čečelice,216,152,368,99.73,70.75,523
CZ020,534765,Dolní Beřkovice,427,393,820,99.27,70.06,1179
CZ020,534773,Dřínov,157,105,262,100.00,71.98,364
CZ020,534790,Horní Počaply,398,308,706,99.86,74.63,950
CZ020,534803,Hořín,327,164,491,99.80,72.35,680
CZ020,534820,Chlumín,132,115,247,100.00,66.04,374
CZ020,534838,Chorušice,133,162,295,99.66,69.48,426
CZ020,534846,Chvatěruby,150,133,283,100.00,68.69,412
CZ020,534897,Kly,568,296,864,99.77,71.28,1215
CZ020,534901,Kokořín,136,92,228,99.56,71.56,320
CZ020,534935,Kostelec nad Labem,1483,753,2236,99.42,72.12,3121
CZ020,534951,Kralupy nad Vltavou,5910,3544,9454,99.64,69.68,13618
CZ020,534978,Ledčice,237,142,379,100.00,71.78,528
CZ020,535001,Liběchov,298,225,523,99.24,63.61,830
CZ020,535028,Lužec nad Vltavou,387,325,712,100.00,66.92,1064
CZ020,535036,Malý Újezd,411,228,639,99.07,75.97,849
CZ020,535044,Mělnické Vtelno,263,242,505,99.61,66.10,767
CZ020,535052,Mšeno,475,330,805,99.63,69.42,1164
CZ020,535061,Nebužely,114,102,216,100.00,65.85,328
CZ020,535079,Nelahozeves,811,376,1187,99.41,76.49,1561
CZ020,535087,Neratovice,4595,3518,8113,99.50,65.30,12492
CZ020,535117,Nová Ves,318,279,597,99.67,76.17,789
CZ020,535133,Obříství,545,326,871,99.77,76.31,1144
CZ020,535141,Ovčáry,171,96,267,99.26,68.27,394
CZ020,535168,Řepín,238,144,382,99.48,74.42,516
CZ020,535192,Spomyšl,112,132,244,100.00,62.24,392
CZ020,535214,Střemy,131,132,263,99.62,70.03,377
CZ020,535222,Tišice,835,496,1331,99.70,72.12,1851
CZ020,535257,Úžice,319,216,535,99.63,76.28,704
CZ020,535265,Velký Borek,388,261,649,99.85,77.38,840
CZ020,535273,Veltrusy,874,438,1312,99.17,79.14,1673
CZ020,535290,Vojkovice,203,188,391,99.74,67.59,580
CZ020,535303,Vraňany,252,221,473,99.58,68.84,690
CZ020,535311,Všestudy,141,82,223,99.55,72.26,310
CZ020,535320,Všetaty,697,467,1164,99.74,66.08,1766
CZ020,535338,Vysoká,288,194,482,100.00,67.51,714
CZ020,535354,Zálezlice,109,76,185,98.93,61.11,306
CZ020,535389,Zlosyň,160,116,276,98.57,72.92,384
CZ020,535397,Želízy,159,99,258,100.00,62.17,415
CZ020,538345,Kojetice,306,193,499,99.60,73.82,680
CZ020,538647,Postřižín,548,266,814,99.75,76.91,1061
CZ020,539201,Dolany nad Vltavou,368,162,530,99.44,76.47,697
CZ020,571784,Libiš,791,500,1291,99.69,73.79,1755
CZ020,571792,Kozomín,174,91,265,99.62,75.78,351
CZ020,598291,Čakovičky,300,97,397,98.76,77.61,518
CZ020,599492,Újezdec,38,41,79,98.75,72.07,111
CZ020,529591,Sedlec,111,41,152,100.00,77.55,196
CZ020,529605,Rokytá,99,95,194,100.00,76.98,252
CZ020,529613,Josefův Důl,105,65,170,99.42,57.38,298
CZ020,535419,Mladá Boleslav,12136,7691,19827,99.36,69.56,28706
CZ020,535427,Bakov nad Jizerou,1625,1129,2754,99.57,73.66,3755
CZ020,535443,Bělá pod Bezdězem,1414,1113,2527,99.65,69.22,3668
CZ020,535451,Benátky nad Jizerou,2377,1455,3832,99.48,69.81,5518
CZ020,535478,Bezno,213,257,470,99.16,68.50,692
CZ020,535486,Bítouchov,128,93,221,99.55,74.25,299
CZ020,535508,Boreč,46,78,124,100.00,56.62,219
CZ020,535516,Boseň,174,140,314,99.37,77.64,407
CZ020,535559,Brodce,301,272,573,99.83,69.16,830
CZ020,535567,Březina,161,101,262,100.00,80.12,327
CZ020,535583,Březno,370,213,583,99.49,76.93,763
CZ020,535605,Bukovno,221,200,421,99.76,76.45,552
CZ020,535621,Čachovice,269,170,439,100.00,64.46,681
CZ020,535630,Čistá,266,186,452,100.00,72.55,623
CZ020,535656,Dlouhá Lhota,184,90,274,98.56,80.35,346
CZ020,535672,Dobrovice,1209,765,1974,99.60,76.03,2607
CZ020,535702,Dolní Bousov,949,692,1641,99.45,76.60,2154
CZ020,535711,Dolní Krupá,68,58,126,100.00,67.91,187
CZ020,535729,Dolní Slivno,110,76,186,98.41,65.29,291
CZ020,535745,Domousnice,79,84,163,97.60,70.46,237
CZ020,535818,Horky nad Jizerou,177,125,302,99.34,66.38,458
CZ020,535834,Horní Bukovina,85,57,142,99.30,70.79,202
CZ020,535869,Hrdlořezy,262,143,405,99.75,74.50,545
CZ020,535923,Chocnějovice,162,79,241,98.77,69.91,349
CZ020,535931,Chotětov,392,278,670,99.70,66.60,1009
CZ020,535966,Jabkenice,149,118,267,99.63,75.71,354
CZ020,535974,Jivina,157,121,278,99.29,75.68,370
CZ020,536008,Katusice,241,175,416,99.52,67.15,624
CZ020,536024,Klášter Hradiště nad Jizerou,347,213,560,99.29,74.60,756
CZ020,536041,Kněžmost,779,493,1272,99.30,76.83,1670
CZ020,536067,Kochánky,155,105,260,99.62,75.65,345
CZ020,536121,Kosořice,161,106,267,98.52,74.04,366
CZ020,536164,Krásná Ves,60,47,107,99.07,73.47,147
CZ020,536172,Krnsko,174,122,296,99.66,70.88,419
CZ020,536181,Kropáčova Vrutice,264,244,508,99.61,69.20,737
CZ020,536202,Ledce,142,117,259,99.23,82.86,315
CZ020,536211,Lhotky,45,45,90,100.00,73.17,123
CZ020,536261,Loukovec,109,82,191,99.48,71.38,269
CZ020,536270,Luštěnice,667,504,1171,99.91,71.92,1631
CZ020,536326,Mnichovo Hradiště,2983,1854,4837,99.55,72.38,6719
CZ020,536334,Němčice,68,48,116,100.00,80.00,145
CZ020,536351,Nepřevázka,160,92,252,99.21,78.88,322
CZ020,536377,Nová Telib,110,64,174,99.43,74.79,234
CZ020,536407,Obruby,82,76,158,100.00,77.07,205
CZ020,536431,Petkovy,114,86,200,99.50,81.05,248
CZ020,536440,Písková Lhota,349,220,569,99.30,79.58,720
CZ020,536458,Plazy,174,120,294,99.66,79.73,370
CZ020,536491,Předměřice nad Jizerou,271,148,419,100.00,75.91,552
CZ020,536580,Řepov,289,141,430,100.00,79.78,539
CZ020,536610,Semčice,260,170,430,100.00,76.11,565
CZ020,536636,Skalsko,111,84,195,100.00,69.89,279
CZ020,536652,Smilovice,253,159,412,99.76,69.41,595
CZ020,536661,Sojovice,205,128,333,99.40,76.66,437
CZ020,536709,Strašnov,108,80,188,100.00,80.69,233
CZ020,536717,Strenice,66,45,111,100.00,77.08,144
CZ020,536768,Sukorady,135,99,234,99.57,77.30,304
CZ020,536857,Velké Všelisy,100,124,224,100.00,70.22,319
CZ020,536938,Všejany,205,156,361,98.90,64.95,562
CZ020,536971,Žďár,525,338,863,99.31,76.70,1133
CZ020,536989,Žerčice,144,96,240,99.17,72.89,332
CZ020,536997,Židněves,151,75,226,99.12,78.89,289
CZ020,557030,Skorkov,276,115,391,99.49,78.92,498
CZ020,565539,Sovínky,106,83,189,99.47,76.61,248
CZ020,565563,Lipník,145,67,212,100.00,72.60,292
CZ020,565571,Vlkava,135,116,251,98.82,72.57,350
CZ020,565580,Plužná,81,63,144,100.00,73.47,196
CZ020,565628,Vinařice,112,57,169,100.00,74.12,228
CZ020,565636,Rohatsko,83,54,137,99.28,74.59,185
CZ020,565644,Mečeříž,177,133,310,99.36,71.72,435
CZ020,565652,Rabakov,27,14,41,100.00,80.39,51
CZ020,565661,Řitonice,27,26,53,100.00,68.83,77
CZ020,565725,Veselice,28,36,64,100.00,62.75,102
CZ020,565733,Hrušov,57,69,126,100.00,72.83,173
CZ020,565750,Bílá Hlína,47,16,63,100.00,70.79,89
CZ020,565784,Charvatce,121,82,203,100.00,76.89,264
CZ020,565822,Mohelnice nad Jizerou,34,21,55,96.49,89.06,64
CZ020,565920,Sudoměř,31,22,53,96.36,67.07,82
CZ020,566039,Jizerní Vtelno,119,79,198,99.50,75.38,264
CZ020,566047,Košátky,83,53,136,100.00,79.19,173
CZ020,570753,Prodašice,35,20,55,100.00,72.37,76
CZ020,570761,Ujkovice,24,44,68,100.00,73.91,92
CZ020,570770,Loukov,56,60,116,99.15,76.47,153
CZ020,570788,Bradlec,578,195,773,99.10,82.47,947
CZ020,570818,Dalovice,98,55,153,100.00,83.15,184
CZ020,570826,Kosmonosy,1580,874,2454,99.19,75.26,3290
CZ020,570842,Vinec,75,75,150,99.34,74.38,203
CZ020,570893,Obrubce,74,66,140,98.59,78.45,181
CZ020,570923,Přepeře,46,36,82,98.80,87.37,95
CZ020,570940,Dolní Stakory,141,51,192,99.48,84.28,229
CZ020,570974,Kolomuty,179,67,246,99.60,85.47,289
CZ020,570982,Tuřice,178,74,252,100.00,82.62,305
CZ020,570991,Ctiměřice,52,32,84,98.82,81.73,104
CZ020,571032,Pěčice,67,66,133,100.00,80.61,165
CZ020,571067,Doubravička,64,20,84,100.00,72.41,116
CZ020,571075,Kluky,35,12,47,100.00,77.05,61
CZ020,571121,Niměřice,107,77,184,98.92,71.81,259
CZ020,571148,Rokytovec,29,60,89,98.89,73.17,123
CZ020,571156,Nemyslovice,33,60,93,100.00,70.45,132
CZ020,571172,Kobylnice,55,40,95,98.96,82.76,116
CZ020,571806,Nová Ves u Bakova,86,79,165,98.80,75.45,224
CZ020,571814,Zdětín,219,131,350,99.15,75.27,469
CZ020,571849,Chudíř,107,49,156,100.00,89.14,175
CZ020,571865,Mukařov,73,53,126,99.21,76.97,165
CZ020,571881,Strážiště,56,31,87,100.00,80.56,108
CZ020,571938,Ptýrov,116,69,185,98.93,80.26,233
CZ020,571946,Branžež,95,66,161,100.00,76.67,210
CZ020,571971,Kováň,33,36,69,97.18,68.93,103
CZ020,571989,Dobšín,104,67,171,97.71,77.43,226
CZ020,571997,Neveklovice,32,12,44,97.78,80.36,56
CZ020,572012,Kovanec,36,28,64,100.00,65.31,98
CZ020,572021,Vrátno,16,55,71,98.61,61.02,118
CZ020,598241,Pětikozly,22,10,32,100.00,54.24,59
CZ020,599514,Březovice,118,62,180,99.45,74.49,243
CZ020,599522,Husí Lhota,68,40,108,99.08,88.62,123
CZ020,599531,Horní Slivno,99,61,160,100.00,63.75,251
CZ020,599557,Koryta,38,21,59,100.00,80.82,73
CZ020,599573,Sezemice,42,36,78,100.00,82.11,95
CZ020,503410,Žitovlice,40,75,115,100.00,74.68,154
CZ020,529630,Kostomlátky,109,78,187,98.42,73.64,258
CZ020,534471,Záhornice,116,115,231,99.57,69.46,334
CZ020,534706,Chroustov,61,81,142,98.61,80.90,178
CZ020,534757,Seletice,59,63,122,99.19,71.51,172
CZ020,534854,Hořany,62,29,91,100.00,70.54,129
CZ020,534862,Zvěřínek,112,47,159,98.15,81.00,200
CZ020,534871,Velenka,128,72,200,100.00,81.63,245
CZ020,534889,Starý Vestec,75,45,120,100.00,83.33,144
CZ020,534919,Netřebice,87,46,133,100.00,70.74,188
CZ020,534943,Kouty,108,74,182,98.91,78.30,235
CZ020,536083,Velenice,65,58,123,100.00,73.21,168
CZ020,537004,Nymburk,4872,3024,7896,99.40,69.65,11412
CZ020,537021,Běrunice,249,247,496,100.00,71.06,698
CZ020,537039,Bobnice,295,224,519,99.81,74.29,700
CZ020,537047,Bříství,132,78,210,100.00,78.36,268
CZ020,537055,Budiměřice,205,171,376,99.73,73.92,510
CZ020,537080,Činěves,150,169,319,100.00,77.43,412
CZ020,537098,Dlouhopolsko,84,68,152,100.00,78.76,193
CZ020,537101,Dobšice,79,56,135,99.26,69.74,195
CZ020,537110,Dvory,157,165,322,98.47,74.66,438
CZ020,537128,Dymokury,254,213,467,99.36,68.81,683
CZ020,537152,Hořátev,302,171,473,100.00,78.70,601
CZ020,537161,Hradčany,89,66,155,99.36,71.23,219
CZ020,537179,Hradištko,336,121,457,99.56,77.01,596
CZ020,537217,Choťánky,161,99,260,98.86,75.14,350
CZ020,537225,Chotěšice,93,91,184,98.92,68.63,271
CZ020,537233,Chrást,200,114,314,99.05,75.84,418
CZ020,537250,Jíkev,98,89,187,98.42,69.85,272
CZ020,537268,Jizbice,146,98,244,99.19,79.87,308
CZ020,537276,Kamenné Zboží,161,136,297,100.00,73.70,403
CZ020,537292,Kněžice,160,177,337,99.70,76.13,444
CZ020,537306,Kolaje,29,21,50,100.00,66.67,75
CZ020,537314,Kostelní Lhota,347,171,518,99.23,77.03,679
CZ020,537331,Kostomlaty nad Labem,661,426,1087,99.63,73.67,1481
CZ020,537349,Košík,108,112,220,99.55,72.46,305
CZ020,537357,Kounice,651,261,912,99.35,79.41,1156
CZ020,537373,Kovanice,314,209,523,99.24,74.44,708
CZ020,537390,Krchleby,201,207,408,99.51,69.73,588
CZ020,537403,Křečkov,149,95,244,99.19,76.40,322
CZ020,537411,Křinec,369,412,781,99.74,73.11,1071
CZ020,537438,Libice nad Cidlinou,390,307,697,99.71,70.88,989
CZ020,537446,Loučeň,507,330,837,99.76,75.38,1113
CZ020,537454,Lysá nad Labem,3740,1657,5397,99.50,75.04,7240
CZ020,537462,Mcely,106,112,218,100.00,71.48,305
CZ020,537489,Městec Králové,853,794,1647,99.52,72.22,2293
CZ020,537497,Milčice,99,63,162,99.39,71.49,228
CZ020,537501,Milovice,3385,1891,5276,99.74,63.67,8311
CZ020,537551,Odřepsy,89,101,190,100.00,72.24,263
CZ020,537560,Okřínek,39,75,114,98.28,77.85,149
CZ020,537578,Opočnice,124,174,298,100.00,80.98,368
CZ020,537586,Opolany,280,236,516,99.04,72.26,721
CZ020,537616,Oskořínek,171,168,339,99.71,76.58,444
CZ020,537624,Ostrá,217,117,334,98.82,77.22,439
CZ020,537632,Pátek,302,152,454,99.78,77.29,590
CZ020,537659,Písková Lhota,178,116,294,100.00,74.81,393
CZ020,537667,Písty,122,135,257,99.23,77.31,335
CZ020,537683,Poděbrady,5785,2560,8345,99.37,75.28,11157
CZ020,537721,Přerov nad Labem,452,217,669,99.70,76.86,873
CZ020,537756,Rožďalovice,437,428,865,99.65,66.92,1297
CZ020,537764,Sadská,1106,679,1785,99.61,71.28,2514
CZ020,537772,Sány,171,143,314,99.68,71.92,438
CZ020,537781,Semice,363,179,542,100.00,72.75,745
CZ020,537799,Senice,65,65,130,100.00,77.38,168
CZ020,537802,Sloveč,151,159,310,100.00,73.29,423
CZ020,537811,Sokoleč,346,305,651,99.39,76.97,851
CZ020,537837,Stará Lysá,230,136,366,99.19,78.68,469
CZ020,537853,Straky,167,121,288,99.31,72.32,401
CZ020,537861,Stratov,234,121,355,100.00,74.42,477
CZ020,537896,Třebestovice,340,176,516,99.81,76.03,680
CZ020,537900,Úmyslovice,105,71,176,100.00,69.02,255
CZ020,537942,Vestec,91,115,206,100.00,77.15,267
CZ020,537951,Vlkov pod Oškobrhem,48,17,65,100.00,85.53,76
CZ020,537977,Vrbová Lhota,182,111,293,99.32,71.26,414
CZ020,537985,Všechlapy,289,183,472,98.74,74.38,644
CZ020,537993,Vykáň,111,111,222,99.55,72.17,309
CZ020,551481,Kněžičky,62,40,102,100.00,67.11,152
CZ020,599581,Jiřice,256,417,673,98.97,86.99,784
CZ020,599590,Podmoky,64,51,115,99.14,71.60,162
CZ020,599611,Vrbice,55,49,104,100.00,72.73,143
CZ020,599620,Chleby,162,93,255,99.22,72.39,355
CZ020,599638,Hrubý Jeseník,170,163,333,100.00,70.70,471
CZ020,599654,Nový Dvůr,21,30,51,100.00,94.44,54
CZ020,599662,Oseček,53,40,93,100.00,68.89,135
CZ020,599671,Čilec,80,51,131,100.00,71.58,183
CZ020,599697,Zbožíčko,62,78,140,100.00,72.92,192
CZ020,505781,Zápy,333,119,452,99.56,71.61,634
CZ020,513628,Klokočná,119,54,173,100.00,78.28,221
CZ020,513644,Zlatá,154,56,210,99.06,81.85,259
CZ020,529656,Pětihosty,108,34,142,100.00,78.02,182
CZ020,531553,Konětopy,116,80,196,100.00,78.09,251
CZ020,533254,Černé Voděrady,139,94,233,100.00,77.41,301
CZ020,533378,Jevany,360,118,478,99.58,77.42,620
CZ020,533416,Kostelec nad Černými lesy,1349,739,2088,99.38,73.51,2858
CZ020,533432,Kozojedy,421,149,570,99.82,80.11,714
CZ020,533548,Nučice,106,92,198,100.00,71.48,277
CZ020,533564,Oleška,260,264,524,99.81,70.19,748
CZ020,533718,Stříbrná Skalice,566,303,869,99.77,71.86,1212
CZ020,533874,Vlkančice,100,38,138,100.00,76.24,181
CZ020,533904,Vyžlovka,323,125,448,99.56,80.36,560
CZ020,534684,Borek,158,45,203,98.54,81.75,252
CZ020,534781,Dřísy,378,190,568,100.00,74.93,758
CZ020,534960,Křenek,129,40,169,99.41,74.89,227
CZ020,534986,Lhota,239,71,310,99.68,84.05,370
CZ020,535362,Záryby,383,203,586,99.66,75.68,777
CZ020,536130,Kostelní Hlavno,174,89,263,100.00,71.66,367
CZ020,538043,Babice,538,195,733,99.05,78.89,938
CZ020,538051,Bašť,947,310,1257,99.68,76.56,1647
CZ020,538086,Bořanovice,363,194,557,98.93,80.66,698
CZ020,538094,Brandýs nad Labem-Stará Boleslav,6783,2947,9730,99.63,73.50,13293
CZ020,538108,Brázdim,266,147,413,99.28,74.55,558
CZ020,538132,Čelákovice,4511,2076,6587,99.14,75.87,8758
CZ020,538141,Čestlice,279,133,412,99.52,76.10,544
CZ020,538167,Dobřejovice,414,170,584,98.48,75.54,785
CZ020,538191,Dřevčice,320,133,453,99.12,75.45,607
CZ020,538221,Horoušany,705,212,917,99.57,79.74,1155
CZ020,538230,Hovorčovice,1009,419,1428,99.44,81.73,1757
CZ020,538248,Hrusice,402,119,521,98.30,79.70,665
CZ020,538256,Husinec,682,151,833,99.17,82.65,1020
CZ020,538264,Jenštejn,529,170,699,99.71,81.44,862
CZ020,538272,Jirny,1259,420,1679,99.41,80.51,2098
CZ020,538281,Kaliště,125,62,187,100.00,72.48,258
CZ020,538299,Kamenice,1977,717,2694,99.59,77.00,3544
CZ020,538311,Klecany,1438,407,1845,99.41,75.48,2459
CZ020,538329,Klíčany,182,65,247,99.60,72.30,343
CZ020,538370,Kostelec u Křížků,323,117,440,99.32,79.39,558
CZ020,538418,Křížkový Újezdec,137,41,178,100.00,81.28,219
CZ020,538426,Kunice,771,243,1014,99.51,81.26,1254
CZ020,538442,Líbeznice,1165,327,1492,99.60,78.65,1906
CZ020,538451,Louňovice,525,179,704,99.44,80.18,883
CZ020,538469,Máslovice,153,81,234,98.73,79.26,299
CZ020,538477,Měšice,833,316,1149,99.14,78.18,1485
CZ020,538485,Mirošovice,574,185,759,99.61,78.96,965
CZ020,538493,Mnichovice,1682,562,2244,99.38,79.65,2835
CZ020,538507,Mochov,354,228,582,99.15,75.55,777
CZ020,538515,Mratín,488,212,700,99.72,78.97,889
CZ020,538523,Mukařov,1118,459,1577,99.75,78.95,2005
CZ020,538540,Nehvizdy,1326,467,1793,99.61,79.34,2270
CZ020,538558,Nová Ves,542,172,714,99.86,77.63,921
CZ020,538566,Nový Vestec,221,69,290,99.32,77.25,378
CZ020,538574,Odolena Voda,2208,1020,3228,99.17,74.48,4381
CZ020,538582,Ondřejov,718,245,963,100.00,75.08,1284
CZ020,538604,Panenské Břežany,269,93,362,98.37,81.96,449
CZ020,538612,Petříkov,278,70,348,99.71,79.68,438
CZ020,538621,Podolanka,220,140,360,99.72,78.99,457
CZ020,538639,Polerady,178,90,268,100.00,74.65,359
CZ020,538655,Předboj,526,123,649,100.00,82.68,785
CZ020,538671,Přezletice,857,237,1094,99.45,80.29,1370
CZ020,538698,Radějovice,231,84,315,99.37,84.31,376
CZ020,538701,Radonice,411,162,573,99.48,76.90,749
CZ020,538728,Říčany,6974,2000,8974,99.50,77.74,11609
CZ020,538752,Senohraby,602,168,770,99.23,81.19,957
CZ020,538761,Sibřina,374,129,503,99.41,73.55,688
CZ020,538779,Sluhy,271,157,428,99.53,77.34,556
CZ020,538787,Sluštice,283,113,396,99.25,75.71,527
CZ020,538809,Strančice,1057,375,1432,99.24,77.51,1863
CZ020,538825,Struhařov,425,157,582,99.32,81.39,720
CZ020,538833,Sulice,1035,312,1347,99.34,83.20,1631
CZ020,538841,Světice,573,193,766,99.35,81.07,951
CZ020,538850,Svojetice,532,213,745,99.87,82.43,905
CZ020,538876,Šestajovice,1638,444,2082,99.52,79.42,2638
CZ020,538884,Škvorec,870,271,1141,99.74,78.00,1468
CZ020,538892,Tehov,501,117,618,99.52,83.24,746
CZ020,538914,Lázně Toušeň,521,253,774,99.49,75.93,1026
CZ020,538957,Úvaly,3123,861,3984,99.28,80.02,5016
CZ020,538965,Veleň,685,244,929,99.46,79.35,1177
CZ020,538973,Veliká Ves,179,36,215,99.54,75.26,287
CZ020,538981,Velké Popovice,1180,425,1605,99.75,76.38,2108
CZ020,538990,Větrušice,252,101,353,100.00,75.43,468
CZ020,539015,Vodochody,220,131,351,98.87,73.20,485
CZ020,539031,Všestary,390,133,523,99.62,73.43,715
CZ020,539040,Vyšehořovice,233,149,382,98.20,78.43,496
CZ020,539058,Zdiby,1512,403,1915,99.48,78.16,2463
CZ020,539066,Zeleneč,1293,382,1675,99.35,80.22,2103
CZ020,539082,Zlonín,403,91,494,99.60,75.49,657
CZ020,539091,Zvánovice,235,117,352,99.44,76.29,464
CZ020,564761,Konojedy,101,61,162,99.39,77.25,211
CZ020,564788,Prusice,32,21,53,100.00,81.54,65
CZ020,564796,Výžerky,43,43,86,100.00,68.25,126
CZ020,564869,Březí,254,93,347,99.71,79.82,436
CZ020,564885,Doubek,209,68,277,100.00,77.37,358
CZ020,564907,Nupaky,576,192,768,99.48,76.06,1015
CZ020,564915,Herink,362,111,473,98.95,82.27,581
CZ020,564974,Káraný,331,154,485,99.39,74.39,656
CZ020,564982,Květnice,865,169,1034,99.33,83.48,1247
CZ020,564991,Křenice,412,97,509,99.41,79.63,643
CZ020,565008,Dobročovice,138,46,184,99.46,79.40,233
CZ020,565989,Hlavenec,150,72,222,99.55,80.80,276
CZ020,571644,Štíhlice,73,38,111,100.00,70.25,158
CZ020,571679,Oplany,42,28,70,98.59,82.56,86
CZ020,571954,Sudovo Hlavno,173,118,291,100.00,76.18,382
CZ020,598267,Modletice,176,64,240,100.00,69.77,344
CZ020,598283,Sedlec,175,61,236,99.58,83.16,285
CZ020,598305,Svémyslice,206,53,259,100.00,80.19,323
CZ020,599221,Popovičky,178,81,259,99.62,84.42,308
CZ020,599719,Tehovec,294,105,399,99.25,78.98,509
CZ031,529729,Kvítkovice,59,22,81,98.78,81.19,101
CZ031,535176,Planá,92,64,156,100.00,73.93,211
CZ031,535206,Dobrá Voda u Českých Budějovic,949,535,1484,99.07,71.40,2098
CZ031,535231,Ostrolovský Újezd,76,41,117,100.00,87.97,133
CZ031,535249,Dasný,149,71,220,100.00,80.59,273
CZ031,535281,Mydlovary,95,74,169,99.41,72.03,236
CZ031,535346,Plav,186,91,277,100.00,78.25,354
CZ031,535371,Nákří,66,59,125,98.43,75.15,169
CZ031,535401,Bošilec,78,57,135,100.00,80.36,168
CZ031,535435,Neplachov,126,93,219,99.10,74.16,298
CZ031,535460,Hradce,50,10,60,100.00,75.00,80
CZ031,535494,Úsilné,178,105,283,100.00,76.49,370
CZ031,535524,Hosty,56,49,105,99.06,75.71,140
CZ031,535541,Čakov,114,48,162,100.00,70.43,230
CZ031,535575,Habří,50,29,79,100.00,85.87,92
CZ031,535591,Zvíkov,101,64,165,100.00,76.04,217
CZ031,535613,Hvozdec,45,41,86,98.85,82.08,106
CZ031,535648,Nová Ves,285,193,478,99.79,79.04,606
CZ031,535664,Doubravice,155,60,215,99.54,86.11,252
CZ031,535681,Borovnice,55,29,84,100.00,71.79,117
CZ031,535699,Petříkov,114,57,171,100.00,69.51,246
CZ031,535737,Vidov,245,123,368,99.73,75.77,487
CZ031,535753,Hůry,235,114,349,99.43,73.58,477
CZ031,535761,Jivno,142,83,225,99.56,74.59,303
CZ031,535788,Dubičné,144,113,257,100.00,75.37,341
CZ031,535796,Vráto,172,90,262,99.24,78.11,338
CZ031,535800,Libníč,187,92,279,99.29,65.81,427
CZ031,535826,Adamov,350,187,537,99.81,75.56,712
CZ031,535842,Mokrý Lom,31,35,66,98.51,74.44,90
CZ031,535851,Hlavatce,61,37,98,100.00,82.35,119
CZ031,535877,Komařice,133,60,193,100.00,68.93,280
CZ031,535893,Vitín,150,104,254,100.00,71.75,354
CZ031,535907,Chotýčany,89,52,141,100.00,73.96,192
CZ031,535915,Vlkov,17,14,31,100.00,81.58,38
CZ031,535940,Mazelov,67,67,134,99.26,75.84,178
CZ031,535958,Drahotěšice,115,74,189,100.00,73.54,257
CZ031,535982,Kamenná,65,86,151,99.34,60.08,253
CZ031,535991,Pištín,215,139,354,99.44,68.46,520
CZ031,536016,Zahájí,174,125,299,100.00,77.06,388
CZ031,536032,Strýčice,13,19,32,100.00,69.57,46
CZ031,536059,Břehov,76,32,108,100.00,78.83,137
CZ031,536075,Hartmanice,60,33,93,100.00,66.43,140
CZ031,536105,Horní Kněžeklady,48,26,74,100.00,75.51,98
CZ031,536156,Bečice,35,27,62,100.00,76.54,81
CZ031,536199,Dobšice,35,23,58,100.00,67.44,86
CZ031,544256,České Budějovice,31689,18350,50039,99.47,69.21,72718
CZ031,544272,Borek,625,335,960,99.38,79.90,1209
CZ031,544281,Borovany,1273,1059,2332,99.40,72.34,3246
CZ031,544299,Boršov nad Vltavou,786,355,1141,99.91,74.01,1543
CZ031,544329,Čejkovice,115,88,203,99.02,68.79,298
CZ031,544361,Dívčice,212,122,334,100.00,70.91,471
CZ031,544388,Dolní Bukovsko,504,445,949,99.68,73.34,1298
CZ031,544400,Doudleby,193,77,270,100.00,71.81,376
CZ031,544426,Dříteň,604,362,966,99.90,74.38,1300
CZ031,544442,Dubné,717,296,1013,99.51,78.61,1295
CZ031,544451,Dynín,127,81,208,100.00,74.82,278
CZ031,544485,Hluboká nad Vltavou,2046,1024,3070,99.22,72.75,4253
CZ031,544493,Homole,704,280,984,99.60,79.29,1246
CZ031,544515,Horní Stropnice,343,472,815,99.88,65.86,1239
CZ031,544523,Hosín,388,162,550,99.28,75.79,731
CZ031,544540,Hranice,53,47,100,100.00,62.50,160
CZ031,544558,Hrdějovice,602,324,926,99.46,77.01,1209
CZ031,544591,Chrášťany,189,212,401,99.01,70.07,578
CZ031,544612,Jankov,148,86,234,98.73,73.60,322
CZ031,544639,Jílovice,286,317,603,99.34,71.58,848
CZ031,544663,Kamenný Újezd,1016,414,1430,98.55,74.26,1954
CZ031,544736,Ledenice,885,502,1387,99.36,71.52,1952
CZ031,544744,Libín,163,96,259,100.00,79.69,325
CZ031,544761,Lipí,244,146,390,99.74,74.48,525
CZ031,544779,Lišov,1471,996,2467,99.44,73.49,3380
CZ031,544795,Litvínovice,1112,446,1558,99.87,79.23,1969
CZ031,544809,Ločenice,253,172,425,99.30,71.10,602
CZ031,544817,Mladošovice,97,124,221,99.55,66.67,333
CZ031,544825,Nedabyle,136,88,224,100.00,81.45,275
CZ031,544868,Nové Hrady,634,710,1344,99.26,67.87,1998
CZ031,544884,Olešnice,242,250,492,98.60,72.85,685
CZ031,544892,Olešník,234,213,447,99.78,70.89,632
CZ031,544965,Radošovice,72,49,121,100.00,76.10,159
CZ031,544973,Roudné,597,242,839,99.64,82.79,1017
CZ031,544981,Rudolfov,895,541,1436,99.17,74.06,1958
CZ031,545007,Římov,381,155,536,99.26,72.78,742
CZ031,545015,Sedlec,191,116,307,100.00,76.37,402
CZ031,545023,Slavče,194,176,370,99.20,68.07,548
CZ031,545066,Srubec,1138,527,1665,99.76,75.91,2200
CZ031,545074,Staré Hodějovice,504,245,749,99.47,74.85,1006
CZ031,545082,Strážkovice,186,111,297,99.00,72.64,413
CZ031,545091,Střížov,97,35,132,98.51,76.57,175
CZ031,545104,Svatý Jan nad Malší,208,123,331,99.70,71.09,467
CZ031,545121,Ševětín,459,312,771,99.36,71.48,1087
CZ031,545139,Štěpánovice,318,230,548,100.00,74.86,732
CZ031,545155,Temelín,259,246,505,99.21,71.49,712
CZ031,545171,Trhové Sviny,1488,1373,2861,99.44,70.57,4078
CZ031,545201,Týn nad Vltavou,2464,1779,4243,99.21,68.69,6231
CZ031,545228,Včelná,882,390,1272,99.38,74.61,1717
CZ031,545261,Vrábče,361,137,498,99.80,78.37,638
CZ031,545287,Všemyslice,403,240,643,99.84,71.88,896
CZ031,545317,Záboří,106,88,194,99.49,66.33,294
CZ031,545341,Zliv,1180,832,2012,99.36,72.22,2808
CZ031,545368,Žabovřesky,169,96,265,99.62,74.09,359
CZ031,545376,Žár,72,110,182,100.00,62.98,289
CZ031,545384,Žimutice,181,185,366,99.46,72.87,505
CZ031,549371,Dražíč,77,85,162,100.00,70.43,230
CZ031,551490,Branišov,123,44,167,98.82,75.45,224
CZ031,551503,Čížkrajice,72,69,141,100.00,66.82,211
CZ031,598593,Heřmaň,85,50,135,99.26,84.47,161
CZ031,598607,Hlincová Hora,216,72,288,99.31,80.56,360
CZ031,598615,Modrá Hůrka,21,21,42,95.45,62.86,70
CZ031,598976,Čenkov u Bechyně,24,15,39,97.50,86.96,46
CZ031,599778,Závraty,24,12,36,100.00,87.80,41
CZ031,500194,Polná na Šumavě,20,57,77,100.00,48.73,158
CZ031,513661,Nová Ves,145,89,234,100.00,71.12,329
CZ031,536229,Chlumec,57,9,66,97.06,87.18,78
CZ031,536237,Zvíkov,34,18,52,100.00,67.53,77
CZ031,536245,Srnín,131,78,209,100.00,82.94,252
CZ031,536253,Bohdalovice,59,81,140,99.29,58.26,242
CZ031,536296,Malšín,67,47,114,99.13,78.77,146
CZ031,536300,Věžovatá Pláně,63,32,95,100.00,77.87,122
CZ031,545392,Český Krumlov,4033,2610,6643,99.51,68.32,9777
CZ031,545406,Benešov nad Černou,269,396,665,99.40,66.60,1006
CZ031,545414,Besednice,263,194,457,99.13,72.26,638
CZ031,545431,Brloh,382,201,583,98.98,69.29,850
CZ031,545449,Bujanov,113,171,284,99.65,63.76,447
CZ031,545457,Černá v Pošumaví,256,180,436,98.87,64.85,680
CZ031,545465,Dolní Dvořiště,1021,449,1470,100.00,79.20,1856
CZ031,545473,Dolní Třebonín,439,314,753,99.87,72.29,1043
CZ031,545481,Frymburk,538,345,883,99.77,72.13,1227
CZ031,545490,Holubov,396,234,630,99.21,79.20,803
CZ031,545503,Horní Dvořiště,101,122,223,99.55,58.79,381
CZ031,545511,Horní Planá,630,564,1194,99.67,68.54,1748
CZ031,545520,Hořice na Šumavě,233,202,435,100.00,63.41,686
CZ031,545546,Chvalšiny,387,347,734,99.73,71.32,1032
CZ031,545554,Kájov,551,484,1035,98.95,72.79,1437
CZ031,545562,Kaplice,1800,1733,3533,99.38,68.17,5215
CZ031,545571,Křemže,1051,586,1637,99.21,72.76,2269
CZ031,545597,Lipno nad Vltavou,700,148,848,100.00,85.31,994
CZ031,545601,Loučovice,369,337,706,99.72,56.10,1262
CZ031,545619,Malonty,325,367,692,99.57,65.51,1064
CZ031,545627,Mirkovice,156,88,244,99.59,68.25,359
CZ031,545643,Netřebice,184,123,307,99.03,72.94,425
CZ031,545660,Omlenice,131,173,304,99.35,68.61,446
CZ031,545694,Pohorská Ves,41,44,85,100.00,46.49,185
CZ031,545716,Přední Výtoň,120,56,176,99.44,72.24,245
CZ031,545724,Přídolí,172,158,330,99.10,67.68,492
CZ031,545732,Přísečná,73,50,123,100.00,80.39,153
CZ031,545767,Rožmberk nad Vltavou,129,84,213,99.53,66.25,323
CZ031,545775,Rožmitál na Šumavě,85,132,217,100.00,62.36,348
CZ031,545805,Soběnov,129,97,226,99.56,79.65,285
CZ031,545813,Světlík,44,65,109,99.09,56.70,194
CZ031,545821,Velešín,1203,839,2042,99.37,67.22,3057
CZ031,545830,Větřní,758,962,1720,99.71,58.34,2957
CZ031,545848,Vyšší Brod,684,451,1135,99.82,65.72,1730
CZ031,545864,Zlatá Koruna,307,161,468,98.94,75.96,624
CZ031,545872,Zubčice,166,75,241,99.18,74.54,326
CZ031,551538,Střítež,165,113,278,100.00,77.01,361
CZ031,598623,Mojné,101,71,172,99.42,82.78,209
CZ031,507610,Doňov,28,23,51,100.00,80.95,63
CZ031,507628,Pleše,54,50,104,99.05,70.95,148
CZ031,507644,Újezdec,22,25,47,100.00,79.66,59
CZ031,507652,Višňová,26,28,54,100.00,78.26,69
CZ031,507695,Záhoří,46,25,71,98.61,74.23,97
CZ031,507717,Peč,119,138,257,99.61,68.25,378
CZ031,507733,Březina,35,44,79,100.00,74.53,106
CZ031,507784,Ratiboř,62,55,117,100.00,69.64,168
CZ031,508004,Roseč,74,55,129,98.47,78.44,167
CZ031,508152,Střížovice,145,147,292,100.00,63.62,459
CZ031,508357,Kostelní Vydří,74,44,118,99.16,80.95,147
CZ031,508501,Lužnice,170,101,271,98.91,78.51,349
CZ031,508683,Záblatí,35,22,57,100.00,81.43,70
CZ031,509078,Plavsko,177,92,269,100.00,73.10,368
CZ031,509108,Kostelní Radouň,124,78,202,99.02,83.95,243
CZ031,509116,Červený Hrádek,59,67,126,100.00,77.78,162
CZ031,509141,Dvory nad Lužnicí,96,114,210,99.53,76.73,275
CZ031,509191,Cep,59,57,116,100.00,77.33,150
CZ031,529753,Dívčí Kopy,27,29,56,100.00,82.35,68
CZ031,529761,Žďár,38,41,79,100.00,85.87,92
CZ031,545881,Jindřichův Hradec,6485,4780,11265,99.39,68.97,16435
CZ031,546020,Budeč,60,64,124,98.41,73.26,172
CZ031,546038,Budíškovice,224,166,390,100.00,69.27,563
CZ031,546054,Cizkrajov,137,158,295,100.00,67.82,435
CZ031,546089,České Velenice,679,667,1346,99.63,57.54,2348
CZ031,546097,Český Rudolec,259,266,525,99.62,70.64,746
CZ031,546101,Číměř,201,227,428,99.77,73.33,585
CZ031,546127,Dačice,2276,1889,4165,99.40,71.84,5838
CZ031,546143,Dešná,125,165,290,100.00,56.86,510
CZ031,546151,Deštná,288,135,423,99.76,71.86,590
CZ031,546291,Hatín,78,68,146,98.65,77.89,190
CZ031,546305,Heřmaneč,33,27,60,98.36,78.21,78
CZ031,546364,Horní Pěna,189,175,364,99.73,74.80,488
CZ031,546381,Horní Radouň,80,85,165,99.40,75.80,219
CZ031,546402,Hospříz,103,146,249,100.00,72.81,342
CZ031,546445,Hříšice,138,82,220,99.55,85.99,257
CZ031,546461,Chlum u Třeboně,504,594,1098,99.28,69.91,1582
CZ031,546500,Jarošov nad Nežárkou,368,291,659,99.40,75.51,878
CZ031,546542,Kardašova Řečice,765,496,1261,99.61,69.81,1815
CZ031,546615,Kunžak,529,301,830,99.05,72.89,1151
CZ031,546623,Lásenice,151,170,321,100.00,70.39,456
CZ031,546666,Lodhéřov,160,220,380,99.22,69.26,553
CZ031,546674,Lomnice nad Lužnicí,550,449,999,99.90,69.01,1449
CZ031,546712,Majdalena,153,112,265,100.00,69.37,382
CZ031,546798,Nová Bystřice,898,819,1717,99.71,66.64,2584
CZ031,546801,Nová Včelnice,636,529,1165,99.83,65.45,1783
CZ031,546844,Novosedly nad Nežárkou,208,176,384,99.48,67.84,569
CZ031,546917,Písečné,94,177,271,100.00,66.58,407
CZ031,546968,Pluhův Žďár,200,159,359,100.00,72.58,496
CZ031,546992,Popelín,130,158,288,100.00,74.61,386
CZ031,547069,Rapšach,119,183,302,100.00,67.56,447
CZ031,547085,Rodvínov,214,168,382,99.74,79.46,482
CZ031,547166,Slavonice,588,721,1309,99.62,70.34,1868
CZ031,547204,Staré Hobzí,127,141,268,100.00,59.82,448
CZ031,547212,Staré Město pod Landštejnem,104,171,275,100.00,69.80,394
CZ031,547221,Stráž nad Nežárkou,291,204,495,99.40,70.04,711
CZ031,547239,Strmilov,436,331,767,99.61,67.13,1147
CZ031,547247,Stříbřec,121,175,296,100.00,75.51,392
CZ031,547263,Studená,679,641,1320,99.70,73.76,1795
CZ031,547280,Suchdol nad Lužnicí,1013,948,1961,99.49,69.87,2821
CZ031,547336,Třeboň,3315,1978,5293,99.55,74.52,7136
CZ031,547441,Volfířov,268,167,435,98.86,76.79,573
CZ031,547468,Zahrádky,74,72,146,99.32,78.19,188
CZ031,560987,Drunče,22,8,30,96.77,70.45,44
CZ031,560995,Rosička,22,20,42,97.67,69.35,62
CZ031,561029,Světce,47,42,89,100.00,70.63,126
CZ031,561037,Vícemil,25,13,38,100.00,62.30,61
CZ031,561045,Smržov,26,39,65,100.00,72.22,90
CZ031,561053,Bednáreček,56,50,106,100.00,68.83,154
CZ031,561061,Horní Skrýchov,84,45,129,100.00,74.57,173
CZ031,561070,Pístina,35,33,68,98.55,83.13,83
CZ031,561088,Příbraz,117,51,168,99.41,71.91,235
CZ031,561703,Člunek,133,187,320,100.00,79.60,402
CZ031,561711,Blažejov,152,126,278,99.64,74.40,375
CZ031,562319,Horní Slatina,53,39,92,100.00,77.97,118
CZ031,562327,Třebětice,141,56,197,100.00,79.44,248
CZ031,562360,Nová Ves nad Lužnicí,100,95,195,100.00,69.64,280
CZ031,562378,Staňkov,62,67,129,100.00,71.27,181
CZ031,562386,Hamr,88,114,202,100.00,71.89,281
CZ031,562416,Dobrohošť,20,10,30,100.00,85.71,35
CZ031,562424,Županovice,12,16,28,100.00,70.00,40
CZ031,562459,Polště,37,24,61,98.39,67.39,92
CZ031,562467,Dolní Pěna,183,74,257,100.00,83.17,309
CZ031,562475,Okrouhlá Radouň,94,44,138,99.28,77.65,179
CZ031,562491,Kačlehy,34,34,68,100.00,79.07,86
CZ031,562548,Bednárec,32,40,72,100.00,77.42,93
CZ031,562599,Velký Ratmírov,61,65,126,99.21,70.56,180
CZ031,562602,Dolní Žďár,55,40,95,98.96,82.76,116
CZ031,562629,Vydří,40,53,93,98.94,75.81,124
CZ031,562637,Frahelž,52,39,91,98.91,74.19,124
CZ031,562653,Ponědrážka,22,19,41,100.00,66.13,62
CZ031,562670,Ponědraž,33,40,73,100.00,66.36,110
CZ031,562688,Klec,50,67,117,100.00,80.69,145
CZ031,562696,Hadravova Rosička,22,15,37,100.00,86.05,43
CZ031,562726,Báňovice,54,12,66,100.00,79.52,83
CZ031,562734,Nová Olešná,50,24,74,100.00,74.00,100
CZ031,562742,Bořetín,26,26,52,100.00,68.42,76
CZ031,562769,Jilem,47,35,82,100.00,85.42,96
CZ031,562785,Horní Němčice,15,30,45,100.00,69.23,65
CZ031,562807,Halámky,66,68,134,100.00,83.75,160
CZ031,562815,Dunajovice,69,50,119,100.00,70.00,170
CZ031,562831,Hrachoviště,21,31,52,100.00,75.36,69
CZ031,562840,Domanín,148,89,237,99.58,73.23,325
CZ031,598631,Kamenný Malíkov,15,28,43,100.00,69.84,63
CZ031,598640,Vlčetínec,24,10,34,100.00,72.34,47
CZ031,598658,Horní Meziříčko,23,39,62,100.00,70.45,88
CZ031,509621,Předotice,190,152,342,100.00,74.03,462
CZ031,509752,Křižanov,34,21,55,98.21,72.73,77
CZ031,529877,Okrouhlá,28,18,46,100.00,79.31,58
CZ031,529885,Stehlovice,30,19,49,98.00,75.76,66
CZ031,549240,Písek,9359,6297,15656,99.59,69.76,22542
CZ031,549258,Albrechtice nad Vltavou,307,244,551,99.46,69.95,792
CZ031,549266,Bernartice,428,386,814,99.63,71.75,1140
CZ031,549291,Božetice,160,72,232,100.00,76.07,305
CZ031,549304,Branice,93,81,174,100.00,71.90,242
CZ031,549321,Cerhonice,54,57,111,99.11,86.82,129
CZ031,549339,Čimelice,320,265,585,98.65,69.36,855
CZ031,549347,Čížová,456,308,764,99.35,77.36,994
CZ031,549363,Dobev,331,267,598,99.83,73.95,810
CZ031,549380,Drhovle,208,158,366,99.46,75.72,486
CZ031,549398,Heřmaň,76,94,170,100.00,73.91,230
CZ031,549410,Hrazany,131,40,171,98.84,76.55,226
CZ031,549428,Hrejkovice,185,101,286,99.65,70.34,408
CZ031,549452,Chyšky,332,248,580,99.66,69.29,840
CZ031,549479,Jetětice,83,71,154,100.00,69.37,222
CZ031,549487,Kestřany,240,160,400,99.75,71.86,558
CZ031,549495,Kluky,191,168,359,99.45,74.13,487
CZ031,549509,Kostelec nad Vltavou,120,102,222,98.67,67.77,332
CZ031,549517,Kovářov,562,312,874,99.43,71.14,1237
CZ031,549525,Králova Lhota,57,71,128,98.46,76.02,171
CZ031,549541,Kučeř,66,48,114,100.00,78.08,146
CZ031,549568,Lety,64,89,153,99.35,70.97,217
CZ031,549576,Milevsko,2710,1732,4442,99.66,67.25,6632
CZ031,549584,Mirotice,402,283,685,98.85,70.57,982
CZ031,549592,Mirovice,388,427,815,99.76,67.74,1206
CZ031,549606,Mišovice,54,94,148,100.00,69.48,213
CZ031,549614,Myslín,29,28,57,100.00,64.04,89
CZ031,549657,Nevězice,47,39,86,100.00,69.35,124
CZ031,549681,Orlík nad Vltavou,108,75,183,98.39,68.38,272
CZ031,549703,Oslov,138,67,205,99.03,77.24,268
CZ031,549711,Ostrovec,102,91,193,99.48,65.76,295
CZ031,549754,Podolí I,98,112,210,100.00,67.96,309
CZ031,549771,Protivín,1349,1249,2598,99.73,69.00,3777
CZ031,549797,Přeštěnice,79,91,170,100.00,73.28,232
CZ031,549801,Putim,174,155,329,99.70,77.10,428
CZ031,549827,Ražice,124,96,220,99.10,64.35,345
CZ031,549843,Sepekov,446,313,759,99.48,70.13,1088
CZ031,549851,Skály,79,100,179,99.44,79.30,227
CZ031,549860,Slabčice,112,94,206,100.00,70.07,294
CZ031,549878,Smetanova Lhota,105,59,164,100.00,73.54,223
CZ031,549932,Tálín,64,41,105,100.00,76.64,137
CZ031,549975,Veselíčko,64,54,118,98.33,64.86,185
CZ031,549991,Vráž,129,85,214,100.00,80.45,266
CZ031,550001,Vrcovice,73,43,116,100.00,72.50,160
CZ031,550027,Záhoří,232,231,463,99.36,76.39,610
CZ031,550035,Zbelítov,105,88,193,99.48,68.31,284
CZ031,550043,Zběšičky,27,31,58,100.00,40.85,142
CZ031,550060,Zhoř,127,44,171,99.42,68.80,250
CZ031,561509,Probulov,25,19,44,100.00,75.86,58
CZ031,561517,Přeborov,52,30,82,98.80,69.17,120
CZ031,561525,Horosedly,51,36,87,98.86,79.28,111
CZ031,561550,Kožlí,23,8,31,100.00,72.09,43
CZ031,562068,Rakovice,90,50,140,99.29,74.21,190
CZ031,562084,Jickovice,44,36,80,100.00,72.07,111
CZ031,562122,Boudy,89,41,130,100.00,76.47,170
CZ031,562149,Minice,19,7,26,100.00,81.25,32
CZ031,562157,Nerestce,41,30,71,98.61,75.00,96
CZ031,562165,Zvíkovské Podhradí,94,50,144,100.00,84.21,171
CZ031,562181,Křenovice,77,47,124,100.00,80.00,155
CZ031,562190,Olešná,34,46,80,100.00,71.43,112
CZ031,562211,Varvažov,63,58,121,100.00,68.75,176
CZ031,562254,Paseky,38,67,105,100.00,71.92,146
CZ031,562271,Temešvár,52,39,91,100.00,81.98,111
CZ031,562289,Vojníkov,34,27,61,100.00,81.33,75
CZ031,562301,Dolní Novosedly,76,61,137,97.16,75.81,186
CZ031,598780,Borovany,63,69,132,100.00,75.43,175
CZ031,598801,Květov,33,36,69,100.00,77.53,89
CZ031,598828,Osek,65,14,79,100.00,75.24,105
CZ031,598844,Vlastec,68,88,156,100.00,85.71,182
CZ031,598852,Vlksice,32,57,89,100.00,76.72,116
CZ031,598861,Žďár,91,61,152,98.70,72.30,213
CZ031,529893,Nicov,29,29,58,100.00,74.36,78
CZ031,529915,Vrbice,23,18,41,100.00,73.21,56
CZ031,529923,Žárovná,26,48,74,98.67,70.75,106
CZ031,537071,Lipovice,46,67,113,100.00,68.07,166
CZ031,537136,Kratušín,21,5,26,100.00,65.00,40
CZ031,537144,Dvory,36,22,58,98.31,77.63,76
CZ031,537187,Drslavice,52,35,87,98.86,87.13,101
CZ031,537195,Zábrdí,22,23,45,100.00,77.59,58
CZ031,537209,Žernovice,114,83,197,98.99,79.28,251
CZ031,537241,Babice,51,27,78,100.00,75.73,103
CZ031,537322,Lužice,13,9,22,100.00,66.67,33
CZ031,537365,Olšovice,24,13,37,100.00,78.72,47
CZ031,537381,Mahouš,53,53,106,100.00,80.30,132
CZ031,537420,Chvalovice,44,50,94,100.00,70.15,134
CZ031,537519,Buk,92,93,185,100.00,79.83,233
CZ031,537527,Bohunice,20,11,31,100.00,83.78,37
CZ031,537535,Újezdec,13,31,44,100.00,63.77,69
CZ031,537543,Pěčnov,45,53,98,98.00,80.65,124
CZ031,545902,Borová Lada,193,74,267,100.00,78.99,338
CZ031,550094,Prachatice,3395,2384,5779,99.48,68.35,8518
CZ031,550116,Bohumilice,94,80,174,98.31,66.04,268
CZ031,550124,Bošice,117,76,193,98.47,69.01,284
CZ031,550159,Bušanovice,80,75,155,100.00,68.28,227
CZ031,550167,Čkyně,500,365,865,99.20,70.72,1233
CZ031,550183,Dub,88,89,177,98.33,59.80,301
CZ031,550205,Horní Vltavice,109,98,207,99.52,64.71,323
CZ031,550221,Hracholusky,140,132,272,100.00,67.83,401
CZ031,550230,Husinec,357,343,700,98.87,65.92,1074
CZ031,550248,Chlumany,122,82,204,99.51,69.97,293
CZ031,550264,Chroboly,154,154,308,98.40,70.02,447
CZ031,550329,Ktiš,109,109,218,98.20,58.68,380
CZ031,550337,Kvilda,454,62,516,99.61,94.53,548
CZ031,550345,Lažiště,89,78,167,100.00,65.49,255
CZ031,550353,Lenora,215,127,342,98.84,64.79,534
CZ031,550361,Lhenice,638,456,1094,99.45,70.29,1565
CZ031,550396,Němčice,73,51,124,100.00,80.52,154
CZ031,550418,Malovice,219,176,395,99.00,75.14,531
CZ031,550426,Mičovice,115,81,196,99.49,70.11,281
CZ031,550434,Nebahovy,183,143,326,99.39,71.62,458
CZ031,550442,Netolice,695,656,1351,99.78,67.73,2002
CZ031,550451,Nová Pec,226,159,385,99.74,76.28,506
CZ031,550485,Radhostice,55,40,95,100.00,72.52,131
CZ031,550515,Stachy,469,307,776,98.85,75.12,1045
CZ031,550523,Stožec,141,56,197,100.00,76.95,256
CZ031,550531,Strážný,149,86,235,100.00,74.37,316
CZ031,550540,Strunkovice nad Blanicí,392,342,734,99.86,73.21,1004
CZ031,550558,Svatá Maří,202,184,386,98.72,74.19,527
CZ031,550574,Šumavské Hoštice,175,99,274,99.28,82.14,336
CZ031,550582,Těšovice,89,83,172,98.29,71.43,245
CZ031,550604,Tvrzice,29,49,78,100.00,72.90,107
CZ031,550621,Vacov,497,371,868,99.31,70.09,1247
CZ031,550647,Vimperk,1981,1648,3629,99.21,63.10,5797
CZ031,550655,Vitějovice,154,149,303,99.67,76.38,398
CZ031,550663,Vlachovo Březí,489,426,915,99.89,68.77,1332
CZ031,550671,Volary,829,1013,1842,99.95,60.87,3028
CZ031,550680,Záblatí,81,65,146,99.32,55.26,266
CZ031,550698,Zálezly,131,77,208,100.00,73.08,286
CZ031,550701,Zbytiny,68,135,203,100.00,73.29,277
CZ031,550728,Zdíkov,612,413,1025,99.61,70.77,1454
CZ031,550761,Želnava,30,42,72,100.00,69.90,103
CZ031,561568,Nové Hutě,146,51,197,98.01,88.16,228
CZ031,561576,Budkov,18,36,54,98.18,69.62,79
CZ031,561649,Lčovice,52,31,83,98.81,71.79,117
CZ031,561673,Křišťanov,16,19,35,100.00,46.05,76
CZ031,563978,Kubova Huť,142,16,158,100.00,88.27,179
CZ031,510068,Čečelovice,63,42,105,100.00,64.42,163
CZ031,529966,Buzice,59,44,103,99.04,75.36,138
CZ031,529982,Chlum,59,53,112,99.12,71.52,158
CZ031,530018,Březí,20,17,37,100.00,61.67,60
CZ031,530034,Stožice,134,99,233,99.57,74.76,313
CZ031,536342,Krajníčko,33,33,66,100.00,73.33,90
CZ031,536369,Hornosín,38,7,45,100.00,78.95,57
CZ031,536415,Měkynec,16,11,27,96.43,77.78,36
CZ031,536423,Radějovice,18,14,32,100.00,78.05,41
CZ031,536466,Mačkov,65,47,112,100.00,44.80,250
CZ031,536474,Němčice,34,38,72,100.00,73.47,98
CZ031,536482,Zahorčice,14,18,32,100.00,65.31,49
CZ031,536504,Vacovice,20,17,37,100.00,82.22,45
CZ031,536512,Truskovice,60,54,114,99.13,71.43,161
CZ031,536539,Milejovice,20,23,43,100.00,89.58,48
CZ031,536547,Přechovice,49,28,77,100.00,65.25,118
CZ031,536555,Krty-Hradec,37,36,73,97.33,75.76,99
CZ031,536563,Mnichov,57,102,159,100.00,81.96,194
CZ031,536598,Tchořovice,90,57,147,100.00,77.37,190
CZ031,536601,Kocelovice,63,39,102,100.00,75.00,136
CZ031,536628,Hlupín,33,33,66,98.51,78.82,85
CZ031,536644,Nebřehovice,49,44,93,98.94,70.15,134
CZ031,536679,Třešovice,24,26,50,100.00,89.29,56
CZ031,536695,Úlehle,34,22,56,100.00,75.68,74
CZ031,536725,Němětice,44,31,75,100.00,77.32,97
CZ031,536741,Velká Turná,51,49,100,100.00,70.92,141
CZ031,536750,Kváskovice,30,34,64,100.00,65.31,98
CZ031,536776,Slaník,42,41,83,100.00,68.03,122
CZ031,536784,Strunkovice nad Volyňkou,59,22,81,97.59,76.85,108
CZ031,536792,Přední Zborovice,35,18,53,100.00,79.10,67
CZ031,536806,Krašlovice,32,61,93,100.00,69.40,134
CZ031,536822,Lom,30,23,53,100.00,56.38,94
CZ031,536831,Libětice,32,29,61,100.00,88.57,70
CZ031,536849,Řepice,174,85,259,98.85,74.72,352
CZ031,536865,Rovná,86,59,145,100.00,74.74,194
CZ031,536873,Zvotoky,17,22,39,100.00,72.22,54
CZ031,536881,Horní Poříčí,127,65,192,98.97,77.60,250
CZ031,536890,Uzeničky,36,33,69,98.57,69.31,101
CZ031,536903,Chobot,11,20,31,100.00,86.11,36
CZ031,536911,Pohorovice,28,21,49,100.00,79.03,62
CZ031,536920,Štěchovice,42,73,115,100.00,68.86,167
CZ031,536946,Kalenice,35,24,59,100.00,79.73,74
CZ031,536954,Krejnice,24,25,49,98.00,86.21,58
CZ031,536962,Nišovice,82,45,127,99.22,74.42,172
CZ031,537063,Bratronice,35,14,49,98.00,89.29,56
CZ031,550787,Strakonice,6323,5457,11780,99.54,68.29,17330
CZ031,550809,Bavorov,382,445,827,98.92,63.38,1319
CZ031,550817,Bělčice,295,266,561,99.64,70.85,796
CZ031,550833,Bílsko,60,62,122,100.00,74.85,163
CZ031,550850,Blatná,2216,1393,3609,99.28,72.23,5035
CZ031,550906,Cehnice,131,162,293,98.32,76.21,391
CZ031,550922,Čejetice,251,241,492,99.39,67.90,729
CZ031,550949,Čepřovice,55,49,104,100.00,64.20,162
CZ031,550957,Čestice,310,248,558,99.11,79.07,712
CZ031,550965,Číčenice,105,139,244,100.00,69.52,351
CZ031,550981,Doubravice,93,57,150,100.00,71.77,209
CZ031,551015,Drahonice,118,102,220,100.00,71.66,307
CZ031,551023,Drážov,76,82,158,99.37,77.94,204
CZ031,551040,Dřešín,94,100,194,100.00,77.60,250
CZ031,551104,Hoslovice,43,70,113,100.00,80.71,140
CZ031,551121,Hoštice,46,45,91,100.00,73.39,124
CZ031,551139,Chelčice,126,80,206,99.52,72.38,286
CZ031,551155,Chrášťovice,80,68,148,98.67,71.09,211
CZ031,551163,Jinín,55,71,126,100.00,71.19,177
CZ031,551180,Kadov,111,97,208,99.05,68.63,306
CZ031,551201,Katovice,462,327,789,99.75,71.71,1103
CZ031,551261,Kraselov,58,59,117,100.00,62.23,188
CZ031,551333,Libějovice,144,133,277,98.93,74.87,374
CZ031,551341,Litochovice,71,89,160,100.00,70.48,227
CZ031,551350,Lnáře,214,183,397,99.25,66.89,598
CZ031,551384,Malenice,272,154,426,98.84,77.52,556
CZ031,551392,Mečichov,80,79,159,99.38,68.67,233
CZ031,551414,Miloňovice,44,96,140,99.29,67.46,209
CZ031,551473,Myštice,108,53,161,100.00,70.74,229
CZ031,551520,Nihošovice,92,89,181,98.91,71.76,255
CZ031,551554,Novosedly,90,123,213,99.53,75.62,283
CZ031,551562,Osek,133,149,282,100.00,53.61,526
CZ031,551571,Paračov,41,38,79,100.00,81.44,97
CZ031,551597,Hajany,63,29,92,100.00,77.31,119
CZ031,551619,Pracejovice,96,89,185,98.93,70.57,265
CZ031,551627,Předmíř,79,86,165,99.40,68.60,242
CZ031,551635,Předslavice,79,63,142,100.00,70.44,203
CZ031,551643,Přešťovice,162,125,287,99.65,73.85,390
CZ031,551660,Radomyšl,370,367,737,100.00,72.97,1010
CZ031,551678,Radošovice,227,155,382,99.74,76.45,501
CZ031,551716,Sedlice,409,336,745,99.20,72.35,1038
CZ031,551741,Skočice,52,74,126,98.44,73.56,174
CZ031,551759,Sousedovice,84,75,159,97.55,73.76,221
CZ031,551775,Strašice,37,69,106,100.00,73.61,144
CZ031,551791,Střelské Hoštice,267,227,494,98.41,70.90,708
CZ031,551830,Škvořetice,99,72,171,98.84,69.60,250
CZ031,551856,Štěkeň,267,221,488,99.80,72.02,679
CZ031,551899,Třebohostice,94,99,193,98.97,73.31,266
CZ031,551937,Uzenice,30,39,69,100.00,69.70,99
CZ031,551953,Vodňany,1947,1593,3540,99.75,70.07,5065
CZ031,551961,Volenice,134,188,322,99.69,71.78,450
CZ031,551970,Volyně,971,668,1639,99.51,68.85,2392
CZ031,551988,Záboří,88,88,176,100.00,66.92,263
CZ031,560171,Budyně,15,14,29,96.67,81.08,37
CZ031,560197,Lažany,32,18,50,100.00,87.72,57
CZ031,560201,Nová Ves,28,28,56,100.00,75.68,74
CZ031,560219,Drachkov,71,44,115,100.00,74.68,154
CZ031,560243,Droužetice,45,33,78,100.00,70.91,110
CZ031,560278,Mutěnice,74,84,158,100.00,69.91,226
CZ031,560391,Kuřimany,15,11,26,100.00,72.22,36
CZ031,560405,Kladruby,19,57,76,100.00,66.67,114
CZ031,561690,Hájek,15,12,27,100.00,72.97,37
CZ031,563951,Únice,23,20,43,100.00,75.44,57
CZ031,598887,Pivkovice,26,23,49,100.00,73.13,67
CZ031,598895,Bezdědovice,115,84,199,100.00,74.81,266
CZ031,598909,Skály,29,17,46,95.83,71.64,67
CZ031,598950,Lažánky,37,17,54,100.00,65.06,83
CZ031,530042,Katov,26,24,50,96.15,83.87,62
CZ031,549631,Nadějkov,267,125,392,99.75,67.47,584
CZ031,551601,Turovec,116,62,178,100.00,79.46,224
CZ031,552046,Tábor,11362,7100,18462,99.55,70.59,26274
CZ031,552054,Bechyně,1613,1214,2827,99.37,70.00,4064
CZ031,552097,Borkovice,93,57,150,100.00,73.53,204
CZ031,552101,Borotín,215,155,370,99.46,74.60,500
CZ031,552127,Bradáčov,11,20,31,100.00,68.89,45
CZ031,552135,Březnice,95,54,149,99.33,78.95,190
CZ031,552143,Budislav,122,91,213,100.00,68.49,311
CZ031,552208,Dírná,157,98,255,99.61,72.11,355
CZ031,552224,Dobronice u Bechyně,35,43,78,98.73,79.80,99
CZ031,552241,Dolní Hořice,223,256,479,99.58,71.47,673
CZ031,552275,Dráchov,67,86,153,100.00,79.69,192
CZ031,552283,Dražice,258,217,475,100.00,73.42,647
CZ031,552291,Dražičky,62,37,99,98.02,79.53,127
CZ031,552321,Hlavatce,152,70,222,99.11,71.11,315
CZ031,552453,Chotěmice,38,31,69,97.18,74.74,95
CZ031,552461,Chotoviny,701,398,1099,99.73,77.93,1414
CZ031,552470,Choustník,184,96,280,99.64,71.68,392
CZ031,552496,Chýnov,879,613,1492,99.07,75.45,1996
CZ031,552534,Jistebnice,728,556,1284,99.61,75.47,1708
CZ031,552585,Košice,275,167,442,99.55,72.43,613
CZ031,552666,Malšice,628,398,1026,99.23,73.23,1412
CZ031,552704,Mladá Vožice,805,663,1468,99.59,69.20,2130
CZ031,552712,Mlýny,39,30,69,100.00,69.70,99
CZ031,552721,Myslkovice,130,109,239,100.00,71.56,334
CZ031,552747,Nemyšl,98,57,155,99.36,70.27,222
CZ031,552763,Nová Ves u Chýnova,137,66,203,100.00,86.75,234
CZ031,552798,Oldřichov,68,69,137,97.16,78.77,179
CZ031,552801,Opařany,444,383,827,99.40,74.42,1118
CZ031,552828,Planá nad Lužnicí,1570,836,2406,99.71,74.73,3229
CZ031,552852,Pohnání,37,18,55,100.00,83.33,66
CZ031,552861,Pojbuky,18,46,64,100.00,67.37,95
CZ031,552895,Přehořov,87,90,177,99.44,68.20,261
CZ031,552917,Radenín,144,117,261,99.62,64.69,405
CZ031,552925,Radětice,92,56,148,98.67,71.77,209
CZ031,552933,Radimovice u Želče,175,80,255,98.84,77.95,331
CZ031,552941,Radkov,72,47,119,100.00,90.15,132
CZ031,552976,Rataje,68,45,113,100.00,64.94,174
CZ031,552992,Ratibořské Hory,234,212,446,99.55,72.26,620
CZ031,553018,Roudná,212,131,343,99.71,74.78,460
CZ031,553034,Řepeč,83,87,170,98.84,76.11,226
CZ031,553069,Sezimovo Ústí,2655,1435,4090,99.71,74.17,5533
CZ031,553077,Skalice,190,146,336,100.00,82.20,410
CZ031,553085,Skopytce,74,23,97,100.00,75.78,128
CZ031,553123,Smilovy Hory,106,98,204,99.51,69.02,297
CZ031,553131,Soběslav,2212,1698,3910,99.74,71.31,5500
CZ031,553140,Stádlec,198,164,362,99.45,77.94,467
CZ031,553166,Sudoměřice u Bechyně,286,167,453,100.00,76.39,593
CZ031,553174,Sudoměřice u Tábora,115,71,186,100.00,77.18,241
CZ031,553182,Sviny,147,59,206,100.00,78.93,261
CZ031,553204,Šebířov,99,102,201,99.50,66.45,304
CZ031,553239,Tučapy,290,190,480,99.79,74.00,650
CZ031,553255,Val,99,60,159,99.38,75.12,213
CZ031,553263,Vesce,105,68,173,100.00,74.25,233
CZ031,553271,Veselí nad Lužnicí,1917,1491,3408,99.62,68.26,5012
CZ031,553280,Vilice,50,57,107,99.07,81.82,132
CZ031,553298,Vlastiboř,115,79,194,99.49,72.49,269
CZ031,553310,Vlkov,63,32,95,97.94,71.85,135
CZ031,553328,Vodice,51,54,105,98.13,71.81,149
CZ031,553361,Zálší,83,74,157,98.74,82.38,193
CZ031,553409,Zvěrotice,139,96,235,100.00,73.90,318
CZ031,553417,Želeč,367,216,583,99.32,77.85,754
CZ031,559016,Nasavrky,31,26,57,96.61,81.94,72
CZ031,560430,Zhoř u Tábora,96,27,123,100.00,82.55,149
CZ031,560448,Běleč,85,42,127,100.00,78.88,161
CZ031,560481,Hlasivo,47,34,81,100.00,69.83,116
CZ031,560511,Řemíčov,36,24,60,100.00,78.95,76
CZ031,560529,Dolní Hrachovice,46,39,85,100.00,77.98,109
CZ031,560553,Pohnánec,19,12,31,100.00,72.09,43
CZ031,560626,Rodná,37,27,64,100.00,71.91,89
CZ031,560634,Krátošice,32,30,62,100.00,65.26,95
CZ031,560669,Skrýchov u Malšic,36,46,82,100.00,67.21,122
CZ031,562866,Mažice,39,38,77,98.72,67.24,116
CZ031,562904,Hodonice,50,35,85,100.00,77.98,109
CZ031,562955,Košín,32,20,52,98.11,77.94,68
CZ031,562963,Jedlany,30,16,46,100.00,83.64,55
CZ031,563030,Krtov,87,34,121,100.00,93.80,129
CZ031,563145,Chrbonín,58,46,104,100.00,87.39,119
CZ031,563153,Třebějice,23,21,44,100.00,88.00,50
CZ031,563170,Svrabov,18,17,35,100.00,89.74,39
CZ031,563196,Radimovice u Tábora,35,18,53,98.15,93.10,58
CZ031,563234,Meziříčí,66,38,104,100.00,75.36,138
CZ031,563251,Balkova Lhota,53,30,83,100.00,72.81,114
CZ031,563307,Drhovice,71,64,135,99.26,75.14,181
CZ031,563366,Bečice,47,10,57,100.00,89.06,64
CZ031,563374,Psárov,37,30,67,100.00,63.81,105
CZ031,563447,Vlčeves,29,44,73,100.00,73.00,100
CZ031,563455,Nová Ves u Mladé Vožice,64,38,102,98.08,66.67,156
CZ031,563544,Libějice,57,24,81,100.00,88.04,92
CZ031,563587,Lom,66,39,105,99.06,82.81,128
CZ031,563625,Haškovcova Lhota,29,20,49,98.00,83.33,60
CZ031,563650,Dlouhá Lhota,74,24,98,100.00,75.97,129
CZ031,563722,Černýšovice,29,38,67,100.00,82.72,81
CZ031,563765,Drahov,56,44,100,100.00,81.97,122
CZ031,563897,Žíšov,83,61,144,100.00,75.39,191
CZ031,563927,Zadní Střítež,1,19,20,95.24,70.00,30
CZ031,563986,Klenovice,248,161,409,100.00,79.26,516
CZ031,598992,Hodětín,25,38,63,98.44,71.91,89
CZ031,599000,Záhoří,14,14,28,100.00,65.12,43
CZ031,599026,Slapsko,46,40,86,98.85,73.11,119
CZ031,599034,Zhoř u Mladé Vožice,35,19,54,94.74,67.06,85
CZ031,599042,Slapy,184,116,300,100.00,78.13,384
CZ031,599115,Řípec,95,93,188,100.00,75.50,249
CZ031,599123,Ústrašice,141,78,219,100.00,76.57,286
CZ031,599255,Mezná,24,46,70,98.59,73.96,96
CZ031,599263,Sedlečko u Soběslavě,65,28,93,100.00,57.41,162
CZ031,599271,Zlukov,93,83,176,100.00,74.58,236
CZ031,599280,Komárov,40,32,72,100.00,69.23,104
